<NA>	ǃ̼
d̪ɮ	d̪͡ɮ̪
dɮ	d͡ɮ
d̪ɮᶣ	d̪͡ɮ̪ᶣ
n̼	n̼
t̼	t̼
z̻	z̻
ʇ̼	ǀ̼
aˀ	aˀ
eˀ	eˀ
iˀ	iˀ
oˀ	oˀ
uˀ	uˀ
yˀ	yˀ
æˀ	æˀ
øˀ	øˀ
œˀ	œˀ
ɐˀ	ɐˀ
ɑˀ	ɑˀ
ɒˀ	ɒˀ
ɔˀ	ɔˀ
ɘˀ	ɘˀ
əˀ	əˀ
ɛˀ	ɛˀ
ɜˀ	ɜˀ
ɞˀ	ɞˀ
ɤˀ	ɤˀ
ɨˀ	ɨˀ
ɪˀ	ɪˀ
ɯˀ	ɯˀ
ɵˀ	ɵˀ
ɶˀ	ɶˀ
ʉˀ	ʉˀ
ʊˀ	ʊˀ
ʌˀ	ʌˀ
ʏˀ	ʏˀ
a	a
aː	aː
aˠː	aːˠ
aˤː	aˤː
a˞	a˞
aˠ	aˠ
aˤ	aˤ
a̘	a̘
a̘ː	a̘ː
a̘ˠ	a̘ˠ
a̙	a̙
a̙ː	a̙ː
a̙ˠ	a̙ˠ
a̝	a̝
a̞	a̞
a̟	a̟
a̠	a̠
a̤	a̤
a̤ː	a̤ː
a̤ˠ	a̤ˠ
a̤ˤ	a̤ˤ
ḁ̤	a̤̥
a̯	a̯
a̰	a̰
a̰ː	a̰ː
a̰ˠ	a̰ˠ
a̰ˤ	a̰ˤ
b	b
bʰ	bʰ
bʲʰ	bʲʰ
bʷʰ	bʷʰ
bʰː	bʰː
bˠʰ	bʰˠ
bˤʰ	bˤʰ
bʲ	bʲ
bʲʷ	bʲʷ
bʲʷʰ	bʲʷʰ
bʲː	bːʲ
bʷ	bʷ
bʷʰː	bʷʰː
bʷˀ	bʷˀ
bʷː	bːʷ
bʷˠ	bʷˠ
bʷˠʰ	bʷˠʰ
bʷˤ	bʷˤ
bʷˤʰ	bʷˤʰ
bˀ	bˀ
bː	bː
bˠː	bːˠ
bˤː	bˤː
bˠ	bˠ
bˤ	bˤ
b̃	b̃
b̃ː	b̃ː
b̃ˤ	b̃ˤ
b̟	b̟
b̠	b̠
bʱ	b̤
bʲʱ	b̤ʲ
bʷʱ	b̤ʷ
bʱː	b̤ː
bˠʱ	b̤ˠ
bˤʱ	b̤ˤ
b̰	b̰
b̰ʲ	b̰ʲ
b̰ʷ	b̰ʷ
b̰ː	b̰ː
b̰ˠ	b̰ˠ
b̰ˤ	b̰ˤ
b̰̃	b̰̃
bd	b͡d
bdʰ	b͡dʰ
bdʲʰ	b͡dʲʰ
bdʷʰ	b͡dʷʰ
bdʰː	b͡dʰː
bdˠʰ	b͡dʰˠ
bdˤʰ	b͡dˤʰ
bdʲ	b͡dʲ
bdʲʷ	b͡dʲʷ
bdʲʷʰ	b͡dʲʷʰ
bdʲː	b͡dːʲ
bdʷ	b͡dʷ
bdʷʰː	b͡dʷʰː
bdʷˀ	b͡dʷˀ
bdʷː	b͡dːʷ
bdʷˠ	b͡dʷˠ
bdʷˠʰ	b͡dʷˠʰ
bdʷˤ	b͡dʷˤ
bdʷˤʰ	b͡dʷˤʰ
bdˀ	b͡dˀ
bdː	b͡dː
bdˠː	b͡dːˠ
bdˤː	b͡dˤː
bdˠ	b͡dˠ
bdˡ	b͡dˡ
bdˤ	b͡dˤ
bd̃	b͡d̃
bd̃ː	b͡d̃ː
bd̃ˤ	b͡d̃ˤ
bd̟	b͡d̟
bd̠	b͡d̠
bdʱ	b͡d̤
bdʲʱ	b͡d̤ʲ
bdʷʱ	b͡d̤ʷ
bdʱː	b͡d̤ː
bdˠʱ	b͡d̤ˠ
bdˤʱ	b͡d̤ˤ
bd̰	b͡d̰
bd̰ʲ	b͡d̰ʲ
bd̰ʷ	b͡d̰ʷ
bd̰ː	b͡d̰ː
bd̰ˠ	b͡d̰ˠ
bd̰ˤ	b͡d̰ˤ
bd̰̃	b͡d̰̃
bd̺	b͡d̺
bd̻	b͡d̻
bdⁿ	b͡dⁿ
bv	b͡v
bvʰ	b͡vʰ
bvʲʰ	b͡vʲʰ
bvʷʰ	b͡vʷʰ
bvʰː	b͡vʰː
bvˠʰ	b͡vʰˠ
bvˤʰ	b͡vˤʰ
bvʲ	b͡vʲ
bvʲʷ	b͡vʲʷ
bvʲʷʰ	b͡vʲʷʰ
bvʲː	b͡vːʲ
bvʷ	b͡vʷ
bvʷʰː	b͡vʷʰː
bvʷˀ	b͡vʷˀ
bvʷː	b͡vːʷ
bvʷˠ	b͡vʷˠ
bvʷˠʰ	b͡vʷˠʰ
bvʷˤ	b͡vʷˤ
bvʷˤʰ	b͡vʷˤʰ
bvˀ	b͡vˀ
bvː	b͡vː
bvˠː	b͡vːˠ
bvˤː	b͡vˤː
bvˠ	b͡vˠ
bvˤ	b͡vˤ
bv̟	b͡v̟
bv̠	b͡v̠
bvʱ	b͡v̤
bvʲʱ	b͡v̤ʲ
bvʷʱ	b͡v̤ʷ
bvʱː	b͡v̤ː
bvˠʱ	b͡v̤ˠ
bvˤʱ	b͡v̤ˤ
bv̰	b͡v̰
bv̰ʲ	b͡v̰ʲ
bv̰ʷ	b͡v̰ʷ
bv̰ː	b͡v̰ː
bv̰ˠ	b͡v̰ˠ
bv̰ˤ	b͡v̰ˤ
bβ	b͡β
bβʰ	b͡βʰ
bβʲʰ	b͡βʲʰ
bβʷʰ	b͡βʷʰ
bβʰː	b͡βʰː
bβˠʰ	b͡βʰˠ
bβˤʰ	b͡βˤʰ
bβʲ	b͡βʲ
bβʲʷ	b͡βʲʷ
bβʲʷʰ	b͡βʲʷʰ
bβʲː	b͡βːʲ
bβʷ	b͡βʷ
bβʷʰː	b͡βʷʰː
bβʷˀ	b͡βʷˀ
bβʷː	b͡βːʷ
bβʷˠ	b͡βʷˠ
bβʷˠʰ	b͡βʷˠʰ
bβʷˤ	b͡βʷˤ
bβʷˤʰ	b͡βʷˤʰ
bβˀ	b͡βˀ
bβː	b͡βː
bβˠː	b͡βːˠ
bβˤː	b͡βˤː
bβˠ	b͡βˠ
bβˤ	b͡βˤ
bβ̃	b͡β̃
bβ̃ː	b͡β̃ː
bβ̃ˤ	b͡β̃ˤ
bβ̟	b͡β̟
bβ̠	b͡β̠
bβʱ	b͡β̤
bβʲʱ	b͡β̤ʲ
bβʷʱ	b͡β̤ʷ
bβʱː	b͡β̤ː
bβˠʱ	b͡β̤ˠ
bβˤʱ	b͡β̤ˤ
bβ̰	b͡β̰
bβ̰ʲ	b͡β̰ʲ
bβ̰ʷ	b͡β̰ʷ
bβ̰ː	b͡β̰ː
bβ̰ˠ	b͡β̰ˠ
bβ̰ˤ	b͡β̰ˤ
bβ̰̃	b͡β̰̃
bṽ	b͡ṽ
bṽː	b͡ṽː
bṽˤ	b͡ṽˤ
bṽ̰	b͡ṽ̰
bⁿ	bⁿ
c	c
cʰ	cʰ
cʲʰ	cʲʰ
cʷʰ	cʷʰ
cʰː	cʰː
cˠʰ	cʰˠ
cˤʰ	cˤʰ
cᶣʰ	cʰᶣ
cʲ	cʲ
cʲʷ	cʲʷ
cʲʷʰ	cʲʷʰ
cʼʲ	cʼʲ
cʲː	cːʲ
cʷ	cʷ
cʷʰː	cʷʰː
cʼʷ	cʼʷ
cʷˀ	cʷˀ
cʷː	cːʷ
cʷˠ	cʷˠ
cʷˠʰ	cʷˠʰ
cʷˤ	cʷˤ
cʷˤʰ	cʷˤʰ
cʼʷˤ	cʷˤʼ
cʼ	cʼ
cʼː	cʼː
cˀ	cˀ
cː	cː
cˠː	cːˠ
cˤː	cˤː
cˠ	cˠ
cˤ	cˤ
cʼˤ	cˤʼ
c̟	c̟
c̠	c̠
cç	c͡ç
cçʰ	c͡çʰ
cçʲʰ	c͡çʲʰ
cçʷʰ	c͡çʷʰ
cçʰː	c͡çʰː
cçˠʰ	c͡çʰˠ
cçˤʰ	c͡çˤʰ
cçᶣʰ	c͡çʰᶣ
cçʲ	c͡çʲ
cçʲʷ	c͡çʲʷ
cçʲʷʰ	c͡çʲʷʰ
cçʼʲ	c͡çʼʲ
cçʲː	c͡çːʲ
cçʷ	c͡çʷ
cçʷʰː	c͡çʷʰː
cçʼʷ	c͡çʼʷ
cçʷˀ	c͡çʷˀ
cçʷː	c͡çːʷ
cçʷˠ	c͡çʷˠ
cçʷˠʰ	c͡çʷˠʰ
cçʷˤ	c͡çʷˤ
cçʷˤʰ	c͡çʷˤʰ
cçʼʷˤ	c͡çʷˤʼ
cçʼ	c͡çʼ
cçʼː	c͡çʼː
cçˀ	c͡çˀ
cçː	c͡çː
cçˠː	c͡çːˠ
cçˤː	c͡çˤː
cçˠ	c͡çˠ
cçˤ	c͡çˤ
cçʼˤ	c͡çˤʼ
cç̟	c͡ç̟
cç̠	c͡ç̠
cç̺	c͡ç̺
cç̻	c͡ç̻
cçᶣ	c͡çᶣ
cᶣ	cᶣ
cⁿ	cⁿ
d	d
dʰ	dʰ
dʲʰ	dʲʰ
dʷʰ	dʷʰ
dʰː	dʰː
dˠʰ	dʰˠ
dˤʰ	dˤʰ
dᶣʰ	dʰᶣ
dʲ	dʲ
dʲʷ	dʲʷ
dʲʷʰ	dʲʷʰ
dʲː	dːʲ
dʷ	dʷ
dʷʰː	dʷʰː
dʷˀ	dʷˀ
dʷː	dːʷ
dʷˠ	dʷˠ
dʷˠʰ	dʷˠʰ
dʷˤ	dʷˤ
dʷˤʰ	dʷˤʰ
dˀ	dˀ
dː	dː
dˠː	dːˠ
dˤː	dˤː
dˠ	dˠ
dˡ	dˡ
dˤ	dˤ
d̃	d̃
d̃ː	d̃ː
d̃ˤ	d̃ˤ
d̟	d̟
d̠	d̠
dʱ	d̤
dʲʱ	d̤ʲ
dʷʱ	d̤ʷ
dʱː	d̤ː
dˠʱ	d̤ˠ
dˤʱ	d̤ˤ
d̪	d̪
d̪ʰ	d̪ʰ
d̪ʲʰ	d̪ʲʰ
d̪ʷʰ	d̪ʷʰ
d̪ʰː	d̪ʰː
d̪ˠʰ	d̪ʰˠ
d̪ˤʰ	d̪ˤʰ
d̪ᶣʰ	d̪ʰᶣ
d̪ʲ	d̪ʲ
d̪ʲʷ	d̪ʲʷ
d̪ʲʷʰ	d̪ʲʷʰ
d̪ʲː	d̪ːʲ
d̪ʷ	d̪ʷ
d̪ʷʰː	d̪ʷʰː
d̪ʷˀ	d̪ʷˀ
d̪ʷː	d̪ːʷ
d̪ʷˠ	d̪ʷˠ
d̪ʷˠʰ	d̪ʷˠʰ
d̪ʷˤ	d̪ʷˤ
d̪ʷˤʰ	d̪ʷˤʰ
d̪ˀ	d̪ˀ
d̪ː	d̪ː
d̪ˠː	d̪ːˠ
d̪ˤː	d̪ˤː
d̪ˠ	d̪ˠ
d̪ˡ	d̪ˡ
d̪ˤ	d̪ˤ
d̪̃	d̪̃
d̪̃ː	d̪̃ː
d̪̃ˤ	d̪̃ˤ
d̪̟	d̪̟
d̪̠	d̪̠
d̪ʱ	d̪̤
d̪ʲʱ	d̪̤ʲ
d̪ʷʱ	d̪̤ʷ
d̪ʱː	d̪̤ː
d̪ˠʱ	d̪̤ˠ
d̪ˤʱ	d̪̤ˤ
d̪̰	d̪̰
d̪̰ʲ	d̪̰ʲ
d̪̰ʷ	d̪̰ʷ
d̪̰ː	d̪̰ː
d̪̰ˠ	d̪̰ˠ
d̪̰ˤ	d̪̰ˤ
d̪̰̃	d̪̰̃
d̪̺	d̪̺
d̪̻	d̪̻
d̼	d̼
dz̪	d̪͡z̪
dz̪ʰ	d̪͡z̪ʰ
dz̪ʲʰ	d̪͡z̪ʲʰ
dz̪ʷʰ	d̪͡z̪ʷʰ
dz̪ʰː	d̪͡z̪ʰː
dz̪ˠʰ	d̪͡z̪ʰˠ
dz̪ˤʰ	d̪͡z̪ˤʰ
dz̪ᶣʰ	d̪͡z̪ʰᶣ
dz̪ʲ	d̪͡z̪ʲ
dz̪ʲʷ	d̪͡z̪ʲʷ
dz̪ʲʷʰ	d̪͡z̪ʲʷʰ
dz̪ʲː	d̪͡z̪ːʲ
dz̪ʷ	d̪͡z̪ʷ
dz̪ʷʰː	d̪͡z̪ʷʰː
dz̪ʷˀ	d̪͡z̪ʷˀ
dz̪ʷː	d̪͡z̪ːʷ
dz̪ʷˠ	d̪͡z̪ʷˠ
dz̪ʷˠʰ	d̪͡z̪ʷˠʰ
dz̪ʷˤ	d̪͡z̪ʷˤ
dz̪ʷˤʰ	d̪͡z̪ʷˤʰ
dz̪ˀ	d̪͡z̪ˀ
dz̪ː	d̪͡z̪ː
dz̪ˠː	d̪͡z̪ːˠ
dz̪ˤː	d̪͡z̪ˤː
dz̪ˠ	d̪͡z̪ˠ
dz̪ˤ	d̪͡z̪ˤ
dz̪̃	d̪͡z̪̃
dz̪̃ː	d̪͡z̪̃ː
dz̪̃ˤ	d̪͡z̪̃ˤ
dz̪̟	d̪͡z̪̟
dz̪̠	d̪͡z̪̠
dz̪ʱ	d̪͡z̪̤
dz̪ʲʱ	d̪͡z̪̤ʲ
dz̪ʷʱ	d̪͡z̪̤ʷ
dz̪ʱː	d̪͡z̪̤ː
dz̪ˠʱ	d̪͡z̪̤ˠ
dz̪ˤʱ	d̪͡z̪̤ˤ
dz̪̰	d̪͡z̪̰
dz̪̰ʲ	d̪͡z̪̰ʲ
dz̪̰ʷ	d̪͡z̪̰ʷ
dz̪̰ː	d̪͡z̪̰ː
dz̪̰ˠ	d̪͡z̪̰ˠ
dz̪̰ˤ	d̪͡z̪̰ˤ
dz̪̰̃	d̪͡z̪̰̃
dz̪̺	d̪͡z̪̺
dz̪̻	d̪͡z̪̻
dz̪ᶣ	d̪͡z̪ᶣ
dð	d̪͡ð
dðʰ	d̪͡ðʰ
dðʲʰ	d̪͡ðʲʰ
dðʷʰ	d̪͡ðʷʰ
dðʰː	d̪͡ðʰː
dðˠʰ	d̪͡ðʰˠ
dðˤʰ	d̪͡ðˤʰ
dðᶣʰ	d̪͡ðʰᶣ
dðʲ	d̪͡ðʲ
dðʲʷ	d̪͡ðʲʷ
dðʲʷʰ	d̪͡ðʲʷʰ
dðʲː	d̪͡ðːʲ
dðʷ	d̪͡ðʷ
dðʷʰː	d̪͡ðʷʰː
dðʷˀ	d̪͡ðʷˀ
dðʷː	d̪͡ðːʷ
dðʷˠ	d̪͡ðʷˠ
dðʷˠʰ	d̪͡ðʷˠʰ
dðʷˤ	d̪͡ðʷˤ
dðʷˤʰ	d̪͡ðʷˤʰ
dðˀ	d̪͡ðˀ
dðː	d̪͡ðː
dðˠː	d̪͡ðːˠ
dðˤː	d̪͡ðˤː
dðˠ	d̪͡ðˠ
dðˤ	d̪͡ðˤ
dð̃	d̪͡ð̃
dð̃ː	d̪͡ð̃ː
dð̃ˤ	d̪͡ð̃ˤ
dð̟	d̪͡ð̟
dð̠	d̪͡ð̠
dðʱ	d̪͡ð̤
dðʲʱ	d̪͡ð̤ʲ
dðʷʱ	d̪͡ð̤ʷ
dðʱː	d̪͡ð̤ː
dðˠʱ	d̪͡ð̤ˠ
dðˤʱ	d̪͡ð̤ˤ
dð̰	d̪͡ð̰
dð̰ʲ	d̪͡ð̰ʲ
dð̰ʷ	d̪͡ð̰ʷ
dð̰ː	d̪͡ð̰ː
dð̰ˠ	d̪͡ð̰ˠ
dð̰ˤ	d̪͡ð̰ˤ
dð̰̃	d̪͡ð̰̃
dð̺	d̪͡ð̺
dð̻	d̪͡ð̻
dðᶣ	d̪͡ðᶣ
d̪ɮʰ	d̪͡ɮ̪ʰ
d̪ɮʲ	d̪͡ɮ̪ʲ
d̪ɮʷʰ	d̪͡ɮ̪ʷʰ
d̪ɮʰː	d̪͡ɮ̪ʰː
d̪ɮˠʰ	d̪͡ɮ̪ʰˠ
d̪ɮˤʰ	d̪͡ɮ̪ˤʰ
d̪ɮᶣʰ	d̪͡ɮ̪ʰᶣ
d̪ɮʲʰ	d̪͡ɮ̪ʲʰ
d̪ɮʲʷ	d̪͡ɮ̪ʲʷ
d̪ɮʲʷʰ	d̪͡ɮ̪ʲʷʰ
d̪ɮʲː	d̪͡ɮ̪ːʲ
d̪ɮʷ	d̪͡ɮ̪ʷ
d̪ɮʷʰː	d̪͡ɮ̪ʷʰː
d̪ɮʷˀ	d̪͡ɮ̪ʷˀ
d̪ɮʷː	d̪͡ɮ̪ːʷ
d̪ɮʷˠ	d̪͡ɮ̪ʷˠ
d̪ɮʷˠʰ	d̪͡ɮ̪ʷˠʰ
d̪ɮʷˤ	d̪͡ɮ̪ʷˤ
d̪ɮʷˤʰ	d̪͡ɮ̪ʷˤʰ
d̪ɮˀ	d̪͡ɮ̪ˀ
d̪ɮː	d̪͡ɮ̪ː
d̪ɮˠː	d̪͡ɮ̪ːˠ
d̪ɮˤː	d̪͡ɮ̪ˤː
d̪ɮˠ	d̪͡ɮ̪ˠ
d̪ɮˤ	d̪͡ɮ̪̃ˤ
d̪ɮ̃	d̪͡ɮ̪̃
d̪ɮ̃ː	d̪͡ɮ̪̃ː
d̪ᶣ	d̪ᶣ
d̪ⁿ	d̪ⁿ
d̰	d̰
d̰ʲ	d̰ʲ
d̰ʷ	d̰ʷ
d̰ː	d̰ː
d̰ˠ	d̰ˠ
d̰ˤ	d̰ˤ
d̰̃	d̰̃
d̺	d̺
d̻	d̻
dz	d͡z
dzʰ	d͡zʰ
dzʲʰ	d͡zʲʰ
dzʷʰ	d͡zʷʰ
dzʰː	d͡zʰː
dzˠʰ	d͡zʰˠ
dzˤʰ	d͡zˤʰ
dzᶣʰ	d͡zʰᶣ
dzʲ	d͡zʲ
dzʲʷ	d͡zʲʷ
dzʲʷʰ	d͡zʲʷʰ
dzʲː	d͡zːʲ
dzʷ	d͡zʷ
dzʷʰː	d͡zʷʰː
dzʷˀ	d͡zʷˀ
dzʷː	d͡zːʷ
dzʷˠ	d͡zʷˠ
dzʷˠʰ	d͡zʷˠʰ
dzʷˤ	d͡zʷˤ
dzʷˤʰ	d͡zʷˤʰ
dzˀ	d͡zˀ
dzː	d͡zː
dzˠː	d͡zːˠ
dzˤː	d͡zˤː
dzˠ	d͡zˠ
dzˤ	d͡zˤ
dz̃	d͡z̃
dz̃ː	d͡z̃ː
dz̃ˤ	d͡z̃ˤ
dz̟	d͡z̟
dz̠	d͡z̠
dzʱ	d͡z̤
dzʲʱ	d͡z̤ʲ
dzʷʱ	d͡z̤ʷ
dzʱː	d͡z̤ː
dzˠʱ	d͡z̤ˠ
dzˤʱ	d͡z̤ˤ
dz̰	d͡z̰
dz̰ʲ	d͡z̰ʲ
dz̰ʷ	d͡z̰ʷ
dz̰ː	d͡z̰ː
dz̰ˠ	d͡z̰ˠ
dz̰ˤ	d͡z̰ˤ
dz̰̃	d͡z̰̃
dz̺	d͡z̺
dz̻	d͡z̻
dzᶣ	d͡zᶣ
dɮʰ	d͡ɮʰ
dɮʲʰ	d͡ɮʲʰ
dɮʷʰ	d͡ɮʷʰ
dɮʰː	d͡ɮʰː
dɮˠʰ	d͡ɮʰˠ
dɮˤʰ	d͡ɮˤʰ
dɮᶣʰ	d͡ɮʰᶣ
dɮʲ	d͡ɮʲ
dɮʲʷ	d͡ɮʲʷ
dɮʲʷʰ	d͡ɮʲʷʰ
dɮʲː	d͡ɮːʲ
dɮʷ	d͡ɮʷ
dɮʷʰː	d͡ɮʷʰː
dɮʷˀ	d͡ɮʷˀ
dɮʷː	d͡ɮːʷ
dɮʷˠ	d͡ɮʷˠ
dɮʷˠʰ	d͡ɮʷˠʰ
dɮʷˤ	d͡ɮʷˤ
dɮʷˤʰ	d͡ɮʷˤʰ
dɮˀ	d͡ɮˀ
dɮː	d͡ɮː
dɮˠː	d͡ɮːˠ
dɮˤː	d͡ɮˤː
dɮˠ	d͡ɮˠ
dɮˤ	d͡ɮˤ
dɮ̃	d͡ɮ̃
dɮ̃ː	d͡ɮ̃ː
dɮ̃ˤ	d͡ɮ̃ˤ
dɮ̟	d͡ɮ̟
dɮ̠	d͡ɮ̠
dɮʱ	d͡ɮ̤
dɮʲʱ	d͡ɮ̤ʲ
dɮʷʱ	d͡ɮ̤ʷ
dɮʱː	d͡ɮ̤ː
dɮˠʱ	d͡ɮ̤ˠ
dɮˤʱ	d͡ɮ̤ˤ
dɮ̰	d͡ɮ̰
dɮ̰ʲ	d͡ɮ̰ʲ
dɮ̰ʷ	d͡ɮ̰ʷ
dɮ̰ː	d͡ɮ̰ː
dɮ̰ˠ	d͡ɮ̰ˠ
dɮ̰ˤ	d͡ɮ̰ˤ
dɮ̰̃	d͡ɮ̰̃
dɮ̺	d͡ɮ̺
dɮ̻	d͡ɮ̻
dɮᶣ	d͡ɮᶣ
dʑ	d͡ʑ
dʑʰ	d͡ʑʰ
dʑʲʰ	d͡ʑʲʰ
dʑʷʰ	d͡ʑʷʰ
dʑʰː	d͡ʑʰː
dʑˠʰ	d͡ʑʰˠ
dʑˤʰ	d͡ʑˤʰ
dʑᶣʰ	d͡ʑʰᶣ
dʑʲ	d͡ʑʲ
dʑʲʷ	d͡ʑʲʷ
dʑʲʷʰ	d͡ʑʲʷʰ
dʑʲː	d͡ʑːʲ
dʑʷ	d͡ʑʷ
dʑʷʰː	d͡ʑʷʰː
dʑʷˀ	d͡ʑʷˀ
dʑʷː	d͡ʑːʷ
dʑʷˠ	d͡ʑʷˠ
dʑʷˠʰ	d͡ʑʷˠʰ
dʑʷˤ	d͡ʑʷˤ
dʑʷˤʰ	d͡ʑʷˤʰ
dʑˀ	d͡ʑˀ
dʑː	d͡ʑː
dʑˠː	d͡ʑːˠ
dʑˤː	d͡ʑˤː
dʑˠ	d͡ʑˠ
dʑˤ	d͡ʑˤ
dʑ̃	d͡ʑ̃
dʑ̃ː	d͡ʑ̃ː
dʑ̃ˤ	d͡ʑ̃ˤ
dʑ̟	d͡ʑ̟
dʑ̠	d͡ʑ̠
dʑʱ	d͡ʑ̤
dʑʲʱ	d͡ʑ̤ʲ
dʑʷʱ	d͡ʑ̤ʷ
dʑʱː	d͡ʑ̤ː
dʑˠʱ	d͡ʑ̤ˠ
dʑˤʱ	d͡ʑ̤ˤ
dʑ̰	d͡ʑ̰
dʑ̰ʲ	d͡ʑ̰ʲ
dʑ̰ʷ	d͡ʑ̰ʷ
dʑ̰ː	d͡ʑ̰ː
dʑ̰ˠ	d͡ʑ̰ˠ
dʑ̰ˤ	d͡ʑ̰ˤ
dʑ̰̃	d͡ʑ̰̃
dʑ̺	d͡ʑ̺
dʑ̻	d͡ʑ̻
dʑᶣ	d͡ʑᶣ
dʒ	d͡ʒ
dʒʰ	d͡ʒʰ
dʒʲʰ	d͡ʒʲʰ
dʒʷʰ	d͡ʒʷʰ
dʒʰː	d͡ʒʰː
dʒˠʰ	d͡ʒʰˠ
dʒˤʰ	d͡ʒˤʰ
dʒᶣʰ	d͡ʒʰᶣ
dʒʲ	d͡ʒʲ
dʒʲʷ	d͡ʒʲʷ
dʒʲʷʰ	d͡ʒʲʷʰ
dʒʲː	d͡ʒːʲ
dʒʷ	d͡ʒʷ
dʒʷʰː	d͡ʒʷʰː
dʒʷˀ	d͡ʒʷˀ
dʒʷː	d͡ʒːʷ
dʒʷˠ	d͡ʒʷˠ
dʒʷˠʰ	d͡ʒʷˠʰ
dʒʷˤ	d͡ʒʷˤ
dʒʷˤʰ	d͡ʒʷˤʰ
dʒˀ	d͡ʒˀ
dʒː	d͡ʒː
dʒˠː	d͡ʒːˠ
dʒˤː	d͡ʒˤː
dʒˠ	d͡ʒˠ
dʒˤ	d͡ʒˤ
dʒ̃	d͡ʒ̃
dʒ̃ː	d͡ʒ̃ː
dʒ̃ˤ	d͡ʒ̃ˤ
dʒ̟	d͡ʒ̟
dʒ̠	d͡ʒ̠
dʒʱ	d͡ʒ̤
dʒʲʱ	d͡ʒ̤ʲ
dʒʷʱ	d͡ʒ̤ʷ
dʒʱː	d͡ʒ̤ː
dʒˠʱ	d͡ʒ̤ˠ
dʒˤʱ	d͡ʒ̤ˤ
dʒ̰	d͡ʒ̰
dʒ̰ʲ	d͡ʒ̰ʲ
dʒ̰ʷ	d͡ʒ̰ʷ
dʒ̰ː	d͡ʒ̰ː
dʒ̰ˠ	d͡ʒ̰ˠ
dʒ̰ˤ	d͡ʒ̰ˤ
dʒ̰̃	d͡ʒ̰̃
dʒ̺	d͡ʒ̺
dʒ̻	d͡ʒ̻
dʒᶣ	d͡ʒᶣ
dᶣ	dᶣ
dⁿ	dⁿ
e	e
eː	eː
eˠː	eːˠ
eˤː	eˤː
e˞	e˞
eˠ	eˠ
eˤ	eˤ
e̘	e̘
e̘ː	e̘ː
e̘ˠ	e̘ˠ
e̙	e̙
e̙ː	e̙ː
e̙ˠ	e̙ˠ
e̝	e̝
e̞	e̞
e̟	e̟
e̠	e̠
e̤	e̤
e̤ː	e̤ː
e̤ˠ	e̤ˠ
e̤ˤ	e̤ˤ
e̥̤	e̤̥
e̥	e̥
e̥ː	e̥ː
e̥ˠ	e̥ˠ
e̥ˤ	e̥ˤ
e̯	e̯
f	f
fʰ	fʰ
fʲʰ	fʲʰ
fʷʰ	fʷʰ
fʰː	fʰː
fˠʰ	fʰˠ
fˤʰ	fˤʰ
fʲ	fʲ
fʲʷ	fʲʷ
fʲʷʰ	fʲʷʰ
fʼʲ	fʼʲ
fʲː	fːʲ
fʷ	fʷ
fʷʰː	fʷʰː
fʼʷ	fʼʷ
fʷˀ	fʷˀ
fʷː	fːʷ
fʷˠ	fʷˠ
fʷˠʰ	fʷˠʰ
fʷˤ	fʷˤ
fʷˤʰ	fʷˤʰ
fʼʷˤ	fʷˤʼ
fʼ	fʼ
fʼː	fʼː
fˀ	fˀ
fː	fː
fˠː	fːˠ
fˤː	fˤː
fˠ	fˠ
fˤ	fˤ
fʼˤ	fˤʼ
f̝	f̝
f̞	f̞
f̟	f̟
f̠	f̠
f̩	f̩
h	h
hʲ	hʲ
hʲʷ	hʲʷ
hʲː	hːʲ
hʷ	hʷ
hʷˀ	hʷˀ
hʷː	hːʷ
hʷˠ	hʷˠ
hʷˤ	hʷˤ
hˀ	hˀ
hː	hː
hˠː	hːˠ
hˤː	hˤː
hˠ	hˠ
hˤ	hˤ
h̝	h̝
h̞	h̞
h̟	h̟
h̠	h̠
h̩	h̩
hᶣ	hᶣ
i	i
iː	iː
iˠː	iːˠ
iˤː	iˤː
i˞	i˞
iˠ	iˠ
iˤ	iˤ
i̘	i̘
i̘ː	i̘ː
i̘ˠ	i̘ˠ
i̙	i̙
i̙ː	i̙ː
i̙ˠ	i̙ˠ
i̝	i̝
i̞	i̞
i̟	i̟
i̠	i̠
i̤	i̤
i̤ː	i̤ː
i̤ˠ	i̤ˠ
i̤ˤ	i̤ˤ
i̥̤	i̤̥
i̥	i̥
i̥ː	i̥ː
i̥ˠ	i̥ˠ
i̥ˤ	i̥ˤ
i̯	i̯
j	j
jʷ	jʷ
jʷˀ	jʷˀ
jʷː	jːʷ
jʷˠ	jʷˠ
jʷˤ	jʷˤ
jˀ	jˀ
jː	jː
jʲː	jːʲ
jˠː	jːˠ
jˤː	jˤː
jˠ	jˠ
jˤ	jˤ
j̃	j̃
j̃ː	j̃ː
j̃ˤ	j̃ˤ
j̝	j̝
j̞	j̞
j̟	j̟
j̠	j̠
jʱ	j̤
jʲʱ	j̤ʲ
jʷʱ	j̤ʷ
jʱː	j̤ː
jˠʱ	j̤ˠ
jˤʱ	j̤ˤ
j̥ʱ	j̤̥
j̊	j̥
j̥ʲ	j̥ʲ
j̥ʷ	j̥ʷ
j̥ː	j̥ː
j̥ˠ	j̥ˠ
j̥ˤ	j̥ˤ
j̩	j̩
j̰	j̰
j̰ʲ	j̰ʲ
j̰ʷ	j̰ʷ
j̰ː	j̰ː
j̰ˠ	j̰ˠ
j̰ˤ	j̰ˤ
j̰̃	j̰̃
jᶣ	jᶣ
k	k
kʰ	kʰ
kʲʰ	kʲʰ
kʷʰ	kʷʰ
kʰː	kʰː
kˠʰ	kʰˠ
kˤʰ	kˤʰ
kᶣʰ	kʰᶣ
kʲ	kʲ
kʲʷ	kʲʷ
kʲʷʰ	kʲʷʰ
kʼʲ	kʼʲ
kʲː	kːʲ
kʷ	kʷ
kʷʰː	kʷʰː
kʼʷ	kʼʷ
kʷˀ	kʷˀ
kʷː	kːʷ
kʷˠ	kʷˠ
kʷˠʰ	kʷˠʰ
kʷˤ	kʷˤ
kʷˤʰ	kʷˤʰ
kʼʷˤ	kʷˤʼ
kʼ	kʼ
kʼː	kʼː
kˀ	kˀ
kː	kː
kˠː	kːˠ
kˤː	kˤː
kˤ	kˤ
kʼˤ	kˤʼ
k̟	k̟
k̠	k̠
kp	k͡p
kpʰ	k͡pʰ
kpʲʰ	k͡pʲʰ
kpʷʰ	k͡pʷʰ
kpʰː	k͡pʰː
kpˠʰ	k͡pʰˠ
kpˤʰ	k͡pˤʰ
kpʲ	k͡pʲ
kpʲʷ	k͡pʲʷ
kpʲʷʰ	k͡pʲʷʰ
kpʼʲ	k͡pʼʲ
kpʲː	k͡pːʲ
kpʷ	k͡pʷ
kpʷʰː	k͡pʷʰː
kpʼʷ	k͡pʼʷ
kpʷˀ	k͡pʷˀ
kpʷː	k͡pːʷ
kpʷˠ	k͡pʷˠ
kpʷˠʰ	k͡pʷˠʰ
kpʷˤ	k͡pʷˤ
kpʷˤʰ	k͡pʷˤʰ
kpʼʷˤ	k͡pʷˤʼ
kpʼ	k͡pʼ
kpʼː	k͡pʼː
kpˀ	k͡pˀ
kpː	k͡pː
kpˠː	k͡pːˠ
kpˤː	k͡pˤː
kpˠ	k͡pˠ
kpˤ	k͡pˤ
kpʼˤ	k͡pˤʼ
kp̟	k͡p̟
kp̠	k͡p̠
kpⁿ	k͡pⁿ
kx	k͡x
kxʰ	k͡xʰ
kxʲʰ	k͡xʲʰ
kxʷʰ	k͡xʷʰ
kxʰː	k͡xʰː
kxˠʰ	k͡xʰˠ
kxˤʰ	k͡xˤʰ
kxᶣʰ	k͡xʰᶣ
kxʲ	k͡xʲ
kxʲʷ	k͡xʲʷ
kxʲʷʰ	k͡xʲʷʰ
kxʼʲ	k͡xʼʲ
kxʲː	k͡xːʲ
kxʷ	k͡xʷ
kxʷʰː	k͡xʷʰː
kxʼʷ	k͡xʼʷ
kxʷˀ	k͡xʷˀ
kxʷː	k͡xːʷ
kxʷˠ	k͡xʷˠ
kxʷˠʰ	k͡xʷˠʰ
kxʷˤ	k͡xʷˤ
kxʷˤʰ	k͡xʷˤʰ
kxʼʷˤ	k͡xʷˤʼ
kxʼ	k͡xʼ
kxʼː	k͡xʼː
kxˀ	k͡xˀ
kxː	k͡xː
kxˠː	k͡xːˠ
kxˤː	k͡xˤː
kxˠ	k͡xˠ
kxˤ	k͡xˤ
kxʼˤ	k͡xˤʼ
kx̟	k͡x̟
kx̠	k͡x̠
kxᶣ	k͡xᶣ
kᶣ	kᶣ
kⁿ	kⁿ
l	l
lʲ	lʲ
lʲʷ	lʲʷ
lʲː	lːʲ
lʷ	lʷ
lʷˀ	lʷˀ
lʷː	lːʷ
lʷˠ	ɫʷˠ
lʷˤ	lʷˤ
lˀ	lˀ
lː	lː
lˠː	ɫːˠ
lˤː	lˤː
lˠ	ɫˠ
lˤ	lˤ
l̃	l̃
l̃ː	l̃ː
l̃ˤ	l̃ˤ
l̝	l̝
l̞	l̞
l̟	l̟
l̠	l̠
lʱ	l̤
lʲʱ	l̤ʲ
lʷʱ	l̤ʷ
lʱː	l̤ː
lˠʱ	ɫ̤ˠ
lˤʱ	l̤ˤ
l̥ʱ	l̤̥
l̥	l̥
l̥ʲ	l̥ʲ
l̥ʷ	l̥ʷ
l̥ː	l̥ː
l̥ˠ	ɫ̥ˠ
l̥ˤ	l̥ˤ
l̩	l̩
l̪	l̪
l̪ʲ	l̪ʲ
l̪ʲʷ	l̪ʲʷ
l̪ʲː	l̪ːʲ
l̪ʷ	l̪ʷ
l̪ʷˀ	l̪ʷˀ
l̪ʷː	l̪ːʷ
l̪ʷˠ	l̪ʷˠ
l̪ʷˤ	l̪ʷˤ
l̪ˀ	l̪ˀ
l̪ː	l̪ː
l̪ˠː	l̪ːˠ
l̪ˤː	l̪ˤː
l̪ˠ	l̴̪
l̪ˤ	l̪ˤ
l̪̃	l̪̃
l̪̃ː	l̪̃ː
l̪̃ˤ	l̪̃ˤ
l̪̝	l̪̝
l̪̞	l̪̞
l̪̟	l̪̟
l̪̠	l̪̠
l̪ʱ	l̪̤
l̪ʲʱ	l̪̤ʲ
l̪ʷʱ	l̪̤ʷ
l̪ʱː	l̪̤ː
l̪ˠʱ	l̪̤ˠ
l̪ˤʱ	l̪̤ˤ
l̪̥ʱ	l̪̤̥
l̪̥	l̪̥
l̪̥ʲ	l̪̥ʲ
l̪̥ʷ	l̪̥ʷ
l̪̥ː	l̪̥ː
l̪̥ˠ	l̪̥ˠ
l̪̥ˤ	l̪̥ˤ
l̪̩	l̪̩
l̪̰	l̪̰
l̪̰ʲ	l̪̰ʲ
l̪̰ʷ	l̪̰ʷ
l̪̰ː	l̪̰ː
l̪̰ˠ	l̪̰ˠ
l̪̰ˤ	l̪̰ˤ
l̪̰̃	l̪̰̃
l̪̺	l̪̺
l̪̻	l̪̻
l̪ᶣ	l̪ᶣ
l̰	l̰
l̰ʲ	l̰ʲ
l̰ʷ	l̰ʷ
l̰ː	l̰ː
l̰ˠ	ɫ̰ˠ
l̰ˤ	l̰ˤ
l̰̃	l̰̃
l̺	l̺
l̻	l̻
lᶣ	lᶣ
m	m
mʲ	mʲ
mʲʷ	mʲʷ
mʲː	mːʲ
mʷ	mʷ
mʷˀ	mʷˀ
mʷː	mːʷ
mʷˠ	mʷˠ
mʷˤ	mʷˤ
mˀ	mˀ
mː	mː
mˠː	mːˠ
mˤː	mˤː
mˠ	mˠ
mˤ	mˤ
m̟	m̟
m̠	m̠
mʱ	m̤
mʲʱ	m̤ʲ
mʷʱ	m̤ʷ
mʱː	m̤ː
mˠʱ	m̤ˠ
mˤʱ	m̤ˤ
m̥ʱ	m̤̥
m̥	m̥
m̥ʲ	m̥ʲ
m̥ʷ	m̥ʷ
m̥ː	m̥ː
m̥ˠ	m̥ˠ
m̥ˤ	m̥ˤ
m̩	m̩
m̰	m̰
m̰ʲ	m̰ʲ
m̰ʷ	m̰ʷ
m̰ː	m̰ː
m̰ˠ	m̰ˠ
m̰ˤ	m̰ˤ
n	n
nʲ	nʲ
nʲʷ	nʲʷ
nʲː	nːʲ
nʷ	nʷ
nʷˀ	nʷˀ
nʷː	nːʷ
nʷˠ	nʷˠ
nʷˤ	nʷˤ
nˀ	nˀ
nː	nː
nˠː	nːˠ
nˤː	nˤː
nˠ	nˠ
nˤ	nˤ
n̟	n̟
n̠	n̠
nʱ	n̤
nʲʱ	n̤ʲ
nʷʱ	n̤ʷ
nʱː	n̤ː
nˠʱ	n̤ˠ
nˤʱ	n̤ˤ
n̥ʱ	n̤̥
n̥	n̥
n̥ʲ	n̥ʲ
n̥ʷ	n̥ʷ
n̥ː	n̥ː
n̥ˠ	n̥ˠ
n̥ˤ	n̥ˤ
n̩	n̩
n̪	n̪
n̪ʲ	n̪ʲ
n̪ʲʷ	n̪ʲʷ
n̪ʲː	n̪ːʲ
n̪ʷ	n̪ʷ
n̪ʷˀ	n̪ʷˀ
n̪ʷː	n̪ːʷ
n̪ʷˠ	n̪ʷˠ
n̪ʷˤ	n̪ʷˤ
n̪ˀ	n̪ˀ
n̪ː	n̪ː
n̪ˠː	n̪ːˠ
n̪ˤː	n̪ˤː
n̪ˠ	n̪ˠ
n̪ˤ	n̪ˤ
n̪̟	n̪̟
n̪̠	n̪̠
n̪ʱ	n̪̤
n̪ʲʱ	n̪̤ʲ
n̪ʷʱ	n̪̤ʷ
n̪ʱː	n̪̤ː
n̪ˠʱ	n̪̤ˠ
n̪ˤʱ	n̪̤ˤ
n̪̥ʱ	n̪̤̥
n̪̥	n̪̥
n̪̥ʲ	n̪̥ʲ
n̪̥ʷ	n̪̥ʷ
n̪̥ː	n̪̥ː
n̪̥ˠ	n̪̥ˠ
n̪̥ˤ	n̪̥ˤ
n̪̩	n̪̩
n̪̰	n̪̰
n̪̰ʲ	n̪̰ʲ
n̪̰ʷ	n̪̰ʷ
n̪̰ː	n̪̰ː
n̪̰ˠ	n̪̰ˠ
n̪̰ˤ	n̪̰ˤ
n̪̺	n̪̺
n̪̻	n̪̻
n̪ᶣ	n̪ᶣ
n̰	n̰
n̰ʲ	n̰ʲ
n̰ʷ	n̰ʷ
n̰ː	n̰ː
n̰ˠ	n̰ˠ
n̰ˤ	n̰ˤ
n̺	n̺
n̻	n̻
nᶣ	nᶣ
o	o
oː	oː
oˠː	oːˠ
oˤː	oˤː
o˞	o˞
oˠ	oˠ
oˤ	oˤ
o̘	o̘
o̘ː	o̘ː
o̘ˠ	o̘ˠ
o̙	o̙
o̙ː	o̙ː
o̙ˠ	o̙ˠ
o̝	o̝
o̞	o̞
o̟	o̟
o̠	o̠
o̤	o̤
o̤ː	o̤ː
o̤ˠ	o̤ˠ
o̤ˤ	o̤ˤ
o̥̤	o̤̥
o̥	o̥
o̥ː	o̥ː
o̥ˠ	o̥ˠ
o̥ˤ	o̥ˤ
o̯	o̯
o̰	o̰
o̰ː	o̰ː
o̰ˠ	o̰ˠ
o̰ˤ	o̰ˤ
p	p
pʰ	pʰ
pʰʲ	pʲʰ
pʷʰ	pʷʰ
pʰː	pʰː
pˠʰ	pʰˠ
pˤʰ	pˤʰ
pʲ	pʲ
pʲʷ	pʲʷ
pʲʷʰ	pʲʷʰ
pʼʲ	pʼʲ
pʲː	pːʲ
pʷ	pʷ
pʷʰː	pʷʰː
pʼʷ	pʼʷ
pʷˀ	pʷˀ
pʷː	pːʷ
pʷˠ	pʷˠ
pʷˠʰ	pʷˠʰ
pʷˤ	pʷˤ
pʷˤʰ	pʷˤʰ
pʼʷˤ	pʷˤʼ
pʼ	pʼ
pʼː	pʼː
pˀ	pˀ
pː	pː
pˠː	pːˠ
pˤː	pˤː
pˠ	pˠ
pˤ	pˤ
pʼˤ	pˤʼ
p̟	p̟
p̠	p̠
pf	p͡f
pfʰ	p͡fʰ
pfʲʰ	p͡fʲʰ
pfʷʰ	p͡fʷʰ
pfʰː	p͡fʰː
pfˠʰ	p͡fʰˠ
pfˤʰ	p͡fˤʰ
pfʲ	p͡fʲ
pfʲʷ	p͡fʲʷ
pfʲʷʰ	p͡fʲʷʰ
pfʼʲ	p͡fʼʲ
pfʲː	p͡fːʲ
pfʷ	p͡fʷ
pfʷʰː	p͡fʷʰː
pfʼʷ	p͡fʼʷ
pfʷˀ	p͡fʷˀ
pfʷː	p͡fːʷ
pfʷˠ	p͡fʷˠ
pfʷˠʰ	p͡fʷˠʰ
pfʷˤ	p͡fʷˤ
pfʷˤʰ	p͡fʷˤʰ
pfʼʷˤ	p͡fʷˤʼ
pfʼ	p͡fʼ
pfʼː	p͡fʼː
pfˀ	p͡fˀ
pfː	p͡fː
pfˠː	p͡fːˠ
pfˤː	p͡fˤː
pfˠ	p͡fˠ
pfˤ	p͡fˤ
pfʼˤ	p͡fˤʼ
pf̟	p͡f̟
pf̠	p͡f̠
pt	p͡t
ptʰ	p͡tʰ
ptʲʰ	p͡tʲʰ
ptʷʰ	p͡tʷʰ
ptʰː	p͡tʰː
ptˠʰ	p͡tʰˠ
ptˤʰ	p͡tˤʰ
ptʲ	p͡tʲ
ptʲʷ	p͡tʲʷ
ptʲʷʰ	p͡tʲʷʰ
ptʼʲ	p͡tʼʲ
ptʲː	p͡tːʲ
ptʷ	p͡tʷ
ptʷʰː	p͡tʷʰː
ptʼʷ	p͡tʼʷ
ptʷˀ	p͡tʷˀ
ptʷː	p͡tːʷ
ptʷˠ	p͡tʷˠ
ptʷˠʰ	p͡tʷˠʰ
ptʷˤ	p͡tʷˤ
ptʷˤʰ	p͡tʷˤʰ
ptʼʷˤ	p͡tʷˤʼ
ptʼ	p͡tʼ
ptʼː	p͡tʼː
ptˀ	p͡tˀ
ptː	p͡tː
ptˠː	p͡tːˠ
ptˤː	p͡tˤː
ptˠ	p͡tˠ
ptˡ	p͡tˡ
ptˤ	p͡tˤ
ptʼˤ	p͡tˤʼ
pt̟	p͡t̟
pt̠	p͡t̠
pt̺	p͡t̺
pt̻	p͡t̻
ptⁿ	p͡tⁿ
pɸ	p͡ɸ
pɸʰ	p͡ɸʰ
pɸʲʰ	p͡ɸʲʰ
pɸʷʰ	p͡ɸʷʰ
pɸʰː	p͡ɸʰː
pɸˠʰ	p͡ɸʰˠ
pɸˤʰ	p͡ɸˤʰ
pɸʲ	p͡ɸʲ
pɸʲʷ	p͡ɸʲʷ
pɸʲʷʰ	p͡ɸʲʷʰ
pɸʼʲ	p͡ɸʼʲ
pɸʲː	p͡ɸːʲ
pɸʷ	p͡ɸʷ
pɸʷʰː	p͡ɸʷʰː
pɸʼʷ	p͡ɸʼʷ
pɸʷˀ	p͡ɸʷˀ
pɸʷː	p͡ɸːʷ
pɸʷˠ	p͡ɸʷˠ
pɸʷˠʰ	p͡ɸʷˠʰ
pɸʷˤ	p͡ɸʷˤ
pɸʷˤʰ	p͡ɸʷˤʰ
pɸʼʷˤ	p͡ɸʷˤʼ
pɸʼ	p͡ɸʼ
pɸʼː	p͡ɸʼː
pɸˀ	p͡ɸˀ
pɸː	p͡ɸː
pɸˠː	p͡ɸːˠ
pɸˤː	p͡ɸˤː
pɸˠ	p͡ɸˠ
pɸˤ	p͡ɸˤ
pɸʼˤ	p͡ɸˤʼ
pɸ̟	p͡ɸ̟
pɸ̠	p͡ɸ̠
pⁿ	pⁿ
q	q
qʰ	qʰ
qʲʰ	qʲʰ
qʷʰ	qʷʰ
qʰː	qʰː
qˠʰ	qʰˠ
qˤʰ	qˤʰ
qᶣʰ	qʰᶣ
qʲ	qʲ
qʲʷ	qʲʷ
qʲʷʰ	qʲʷʰ
qʼʲ	qʼʲ
qʲː	qːʲ
qʷ	qʷ
qʷʰː	qʷʰː
qʼʷ	qʼʷ
qʷˀ	qʷˀ
qʷː	qːʷ
qʷˠ	qʷˠ
qʷˠʰ	qʷˠʰ
qʷˤ	qʷˤ
qʷˤʰ	qʷˤʰ
qʼʷˤ	qʷˤʼ
qʼ	qʼ
qʼː	qʼː
qˀ	qˀ
qː	qː
qˠː	qːˠ
qˤː	qˤː
qˠ	qˠ
qˤ	qˤ
qʼˤ	qˤʼ
q̟	q̟
q̠	q̠
qχ	q͡χ
qχʰ	q͡χʰ
qχʲʰ	q͡χʲʰ
qχʷʰ	q͡χʷʰ
qχʰː	q͡χʰː
qχˠʰ	q͡χʰˠ
qχˤʰ	q͡χˤʰ
qχᶣʰ	q͡χʰᶣ
qχʲ	q͡χʲ
qχʲʷ	q͡χʲʷ
qχʲʷʰ	q͡χʲʷʰ
qχʼʲ	q͡χʼʲ
qχʲː	q͡χːʲ
qχʷ	q͡χʷ
qχʷʰː	q͡χʷʰː
qχʼʷ	q͡χʼʷ
qχʷˀ	q͡χʷˀ
qχʷː	q͡χːʷ
qχʷˠ	q͡χʷˠ
qχʷˠʰ	q͡χʷˠʰ
qχʷˤ	q͡χʷˤ
qχʷˤʰ	q͡χʷˤʰ
qχʼʷˤ	q͡χʷˤʼ
qχʼ	q͡χʼ
qχʼː	q͡χʼː
qχˀ	q͡χˀ
qχː	q͡χː
qχˠː	q͡χːˠ
qχˤː	q͡χˤː
qχˠ	q͡χˠ
qχˤ	q͡χˤ
qχʼˤ	q͡χˤʼ
qχ̟	q͡χ̟
qχ̠	q͡χ̠
qχᶣ	q͡χᶣ
qᶣ	qᶣ
qⁿ	qⁿ
r	r
rʲ	rʲ
rʲʷ	rʲʷ
rʲː	rːʲ
rʷ	rʷ
rʷˀ	rʷˀ
rʷː	rːʷ
rʷˠ	rʷˠ
rʷˤ	rʷˤ
rˀ	rˀ
rː	rː
rˠː	rːˠ
rˤː	rˤː
rˠ	rˠ
rˤ	rˤ
r̃	r̃
r̃ː	r̃ː
r̃ˤ	r̃ˤ
r̝	r̝
r̞	r̞
r̟	r̟
r̠	r̠
rʱ	r̤
rʲʱ	r̤ʲ
rʷʱ	r̤ʷ
rʱː	r̤ː
rˠʱ	r̤ˠ
rˤʱ	r̤ˤ
r̥ʱ	r̤̥
r̥	r̥
r̥ʲ	r̥ʲ
r̥ʷ	r̥ʷ
r̥ː	r̥ː
r̥ˠ	r̥ˠ
r̥ˤ	r̥ˤ
r̩	r̩
r̪	r̪
r̪ʲ	r̪ʲ
r̪ʲʷ	r̪ʲʷ
r̪ʲː	r̪ːʲ
r̪ʷ	r̪ʷ
r̪ʷˀ	r̪ʷˀ
r̪ʷː	r̪ːʷ
r̪ʷˠ	r̪ʷˠ
r̪ʷˤ	r̪ʷˤ
r̪ˀ	r̪ˀ
r̪ː	r̪ː
r̪ˠː	r̪ːˠ
r̪ˤː	r̪ˤː
r̪ˠ	r̪ˠ
r̪ˤ	r̪ˤ
r̪̃	r̪̃
r̪̃ː	r̪̃ː
r̪̃ˤ	r̪̃ˤ
r̪̝	r̪̝
r̪̞	r̪̞
r̪̟	r̪̟
r̪̠	r̪̠
r̪ʱ	r̪̤
r̪ʲʱ	r̪̤ʲ
r̪ʷʱ	r̪̤ʷ
r̪ʱː	r̪̤ː
r̪ˠʱ	r̪̤ˠ
r̪ˤʱ	r̪̤ˤ
r̪̥ʱ	r̪̤̥
r̪̥	r̪̥
r̪̥ʲ	r̪̥ʲ
r̪̥ʷ	r̪̥ʷ
r̪̥ː	r̪̥ː
r̪̥ˠ	r̪̥ˠ
r̪̥ˤ	r̪̥ˤ
r̪̩	r̪̩
r̪̰	r̪̰
r̪̰ʲ	r̪̰ʲ
r̪̰ʷ	r̪̰ʷ
r̪̰ː	r̪̰ː
r̪̰ˠ	r̪̰ˠ
r̪̰ˤ	r̪̰ˤ
r̪̰̃	r̪̰̃
r̪̺	r̪̺
r̪̻	r̪̻
r̪ᶣ	r̪ᶣ
r̰	r̰
r̰ʲ	r̰ʲ
r̰ʷ	r̰ʷ
r̰ː	r̰ː
r̰ˠ	r̰ˠ
r̰ˤ	r̰ˤ
r̰̃	r̰̃
r̺	r̺
r̻	r̻
rᶣ	rᶣ
s	s
sʰ	sʰ
sʲʰ	sʲʰ
sʷʰ	sʷʰ
sʰː	sʰː
sˠʰ	sʰˠ
sˤʰ	sˤʰ
sᶣʰ	sʰᶣ
sʲ	sʲ
sʲʷ	sʲʷ
sʲʷʰ	sʲʷʰ
sʼʲ	sʼʲ
sʲː	sːʲ
sʷ	sʷ
sʷʰː	sʷʰː
sʼʷ	sʼʷ
sʷˀ	sʷˀ
sʷː	sːʷ
sʷˠ	sʷˠ
sʷˠʰ	sʷˠʰ
sʷˤ	sʷˤ
sʷˤʰ	sʷˤʰ
sʼʷˤ	sʷˤʼ
sʼ	sʼ
sʼː	sʼː
sˀ	sˀ
sː	sː
sˠː	sːˠ
sˤː	sˤː
sˠ	sˠ
sˤ	sˤ
sʼˤ	sˤʼ
s̝	s̝
s̞	s̞
s̟	s̟
s̠	s̠
s̩	s̩
s̪	s̪
s̪ʰ	s̪ʰ
s̪ʲʰ	s̪ʲʰ
s̪ʷʰ	s̪ʷʰ
s̪ʰː	s̪ʰː
s̪ˠʰ	s̪ʰˠ
s̪ˤʰ	s̪ˤʰ
s̪ᶣʰ	s̪ʰᶣ
s̪ʲ	s̪ʲ
s̪ʲʷ	s̪ʲʷ
s̪ʲʷʰ	s̪ʲʷʰ
s̪ʼʲ	s̪ʼʲ
s̪ʲː	s̪ːʲ
s̪ʷ	s̪ʷ
s̪ʷʰː	s̪ʷʰː
s̪ʼʷ	s̪ʼʷ
s̪ʷˀ	s̪ʷˀ
s̪ʷː	s̪ːʷ
s̪ʷˠ	s̪ʷˠ
s̪ʷˠʰ	s̪ʷˠʰ
s̪ʷˤ	s̪ʷˤ
s̪ʷˤʰ	s̪ʷˤʰ
s̪ʼʷˤ	s̪ʷˤʼ
s̪ʼ	s̪ʼ
s̪ʼː	s̪ʼː
s̪ˀ	s̪ˀ
s̪ː	s̪ː
s̪ˠː	s̪ːˠ
s̪ˤː	s̪ˤː
s̪ˠ	s̪ˠ
s̪ˤ	s̪ˤ
s̪ʼˤ	s̪ˤʼ
s̪̝	s̪̝
s̪̞	s̪̞
s̪̟	s̪̟
s̪̠	s̪̠
s̪̩	s̪̩
s̪̺	s̪̺
s̪̻	s̪̻
s̪ᶣ	s̪ᶣ
s̺	s̺
s̻	s̻
sᶣ	sᶣ
t	t
tʰ	tʰ
tʲʰ	tʲʰ
tʷʰ	tʷʰ
tʰː	tʰː
tˠʰ	tʰˠ
tˤʰ	tˤʰ
tᶣʰ	tʰᶣ
tʲ	tʲ
tʲʷ	tʲʷ
tʲʷʰ	tʲʷʰ
tʼʲ	tʼʲ
tʲː	tːʲ
tʷ	tʷ
tʷʰː	tʷʰː
tʼʷ	tʼʷ
tʷˀ	tʷˀ
tʷː	tːʷ
tʷˠ	tʷˠ
tʷˠʰ	tʷˠʰ
tʷˤ	tʷˤ
tʷˤʰ	tʷˤʰ
tʼʷˤ	tʷˤʼ
tʼ	tʼ
tʼː	tʼː
tˀ	tˀ
tː	tː
tˠː	tːˠ
tˤː	tˤː
tˠ	tˠ
tˡ	tˡ
tˤ	tˤ
tʼˤ	tˤʼ
t̟	t̟
t̠	t̠
t̪	t̪
t̪ʰ	t̪ʰ
t̪ʰʲ	t̪ʲʰ
t̪ʷʰ	t̪ʷʰ
t̪ʰː	t̪ʰː
t̪ˠʰ	t̪ʰˠ
t̪ˤʰ	t̪ˤʰ
t̪ᶣʰ	t̪ʰᶣ
t̪ʲ	t̪ʲ
t̪ʲʷ	t̪ʲʷ
t̪ʲʷʰ	t̪ʲʷʰ
t̪ʼʲ	t̪ʼʲ
t̪ʲː	t̪ːʲ
t̪ʷ	t̪ʷ
t̪ʷʰː	t̪ʷʰː
t̪ʼʷ	t̪ʼʷ
t̪ʷˀ	t̪ʷˀ
t̪ʷː	t̪ːʷ
t̪ʷˠ	t̪ʷˠ
t̪ʷˠʰ	t̪ʷˠʰ
t̪ʷˤ	t̪ʷˤ
t̪ʷˤʰ	t̪ʷˤʰ
t̪ʼʷˤ	t̪ʷˤʼ
t̪ʼ	t̪ʼ
t̪ʼː	t̪ʼː
t̪ˀ	t̪ˀ
t̪ː	t̪ː
t̪ˠː	t̪ːˠ
t̪ˤː	t̪ˤː
t̪ˠ	t̪ˠ
t̪ˡ	t̪ˡ
t̪ˤ	t̪ˤ
t̪ʼˤ	t̪ˤʼ
t̪̟	t̪̟
t̪̠	t̪̠
t̪̺	t̪̺
t̪̻	t̪̻
ts̪	t̪͡s̪
ts̪ʰ	t̪͡s̪ʰ
ts̪ʲʰ	t̪͡s̪ʲʰ
ts̪ʷʰ	t̪͡s̪ʷʰ
ts̪ʰː	t̪͡s̪ʰː
ts̪ˠʰ	t̪͡s̪ʰˠ
ts̪ˤʰ	t̪͡s̪ˤʰ
ts̪ᶣʰ	t̪͡s̪ʰᶣ
ts̪ʲ	t̪͡s̪ʲ
ts̪ʲʷ	t̪͡s̪ʲʷ
ts̪ʲʷʰ	t̪͡s̪ʲʷʰ
ts̪ʼʲ	t̪͡s̪ʼʲ
ts̪ʲː	t̪͡s̪ːʲ
ts̪ʷ	t̪͡s̪ʷ
ts̪ʷʰː	t̪͡s̪ʷʰː
ts̪ʼʷ	t̪͡s̪ʼʷ
ts̪ʷˀ	t̪͡s̪ʷˀ
ts̪ʷː	t̪͡s̪ːʷ
ts̪ʷˠ	t̪͡s̪ʷˠ
ts̪ʷˠʰ	t̪͡s̪ʷˠʰ
ts̪ʷˤ	t̪͡s̪ʷˤ
ts̪ʷˤʰ	t̪͡s̪ʷˤʰ
ts̪ʼʷˤ	t̪͡s̪ʷˤʼ
ts̪ʼ	t̪͡s̪ʼ
ts̪ʼː	t̪͡s̪ʼː
ts̪ˀ	t̪͡s̪ˀ
ts̪ː	t̪͡s̪ː
ts̪ˠː	t̪͡s̪ːˠ
ts̪ˤː	t̪͡s̪ˤː
ts̪ˠ	t̪͡s̪ˠ
ts̪ˤ	t̪͡s̪ˤ
ts̪ʼˤ	t̪͡s̪ˤʼ
ts̪̟	t̪͡s̪̟
ts̪̠	t̪͡s̪̠
ts̪̺	t̪͡s̪̺
ts̪̻	t̪͡s̪̻
ts̪ᶣ	t̪͡s̪ᶣ
tɬ̪	t̪͡ɬ̪
tɬ̪ʰ	t̪͡ɬ̪ʰ
tɬ̪ʲʰ	t̪͡ɬ̪ʲʰ
tɬ̪ʷʰ	t̪͡ɬ̪ʷʰ
tɬ̪ʰː	t̪͡ɬ̪ʰː
tɬ̪ˠʰ	t̪͡ɬ̪ʰˠ
tɬ̪ˤʰ	t̪͡ɬ̪ˤʰ
tɬ̪ᶣʰ	t̪͡ɬ̪ʰᶣ
tɬ̪ʲ	t̪͡ɬ̪ʲ
tɬ̪ʲʷ	t̪͡ɬ̪ʲʷ
tɬ̪ʲʷʰ	t̪͡ɬ̪ʲʷʰ
tɬ̪ʼʲ	t̪͡ɬ̪ʼʲ
tɬ̪ʲː	t̪͡ɬ̪ːʲ
tɬ̪ʷ	t̪͡ɬ̪ʷ
tɬ̪ʷʰː	t̪͡ɬ̪ʷʰː
tɬ̪ʼʷ	t̪͡ɬ̪ʼʷ
tɬ̪ʷˀ	t̪͡ɬ̪ʷˀ
tɬ̪ʷː	t̪͡ɬ̪ːʷ
tɬ̪ʷˠ	t̪͡ɬ̪ʷˠ
tɬ̪ʷˠʰ	t̪͡ɬ̪ʷˠʰ
tɬ̪ʷˤ	t̪͡ɬ̪ʷˤ
tɬ̪ʷˤʰ	t̪͡ɬ̪ʷˤʰ
tɬ̪ʼʷˤ	t̪͡ɬ̪ʷˤʼ
tɬ̪ʼ	t̪͡ɬ̪ʼ
tɬ̪ʼː	t̪͡ɬ̪ʼː
tɬ̪ˀ	t̪͡ɬ̪ˀ
tɬ̪ː	t̪͡ɬ̪ː
tɬ̪ˠː	t̪͡ɬ̪ːˠ
tɬ̪ˤː	t̪͡ɬ̪ˤː
tɬ̪ˠ	t̪͡ɬ̪ˠ
tɬ̪ˤ	t̪͡ɬ̪ˤ
tɬ̪ʼˤ	t̪͡ɬ̪ˤʼ
tɬ̪̟	t̪͡ɬ̪̟
tɬ̪̠	t̪͡ɬ̪̠
tɬ̪̺	t̪͡ɬ̪̺
tɬ̪̻	t̪͡ɬ̪̻
tɬ̪ᶣ	t̪͡ɬ̪ᶣ
tθ	t̪͡θ̠
tθʰ	t̪͡θʰ
tθʲʰ	t̪͡θʲʰ
tθʷʰ	t̪͡θʷʰ
tθʰː	t̪͡θʰː
tθˠʰ	t̪͡θʰˠ
tθˤʰ	t̪͡θˤʰ
tθᶣʰ	t̪͡θʰᶣ
tθʲ	t̪͡θʲ
tθʲʷ	t̪͡θʲʷ
tθʲʷʰ	t̪͡θʲʷʰ
tθʼʲ	t̪͡θʼʲ
tθʲː	t̪͡θːʲ
tθʷ	t̪͡θʷ
tθʷʰː	t̪͡θʷʰː
tθʼʷ	t̪͡θʼʷ
tθʷˀ	t̪͡θʷˀ
tθʷː	t̪͡θːʷ
tθʷˠ	t̪͡θʷˠ
tθʷˠʰ	t̪͡θʷˠʰ
tθʷˤ	t̪͡θʷˤ
tθʷˤʰ	t̪͡θʷˤʰ
tθʼʷˤ	t̪͡θʷˤʼ
tθʼ	t̪͡θʼ
tθʼː	t̪͡θʼː
tθˀ	t̪͡θˀ
tθː	t̪͡θː
tθˠː	t̪͡θːˠ
tθˤː	t̪͡θˤː
tθˠ	t̪͡θˠ
tθˤ	t̪͡θˤ
tθʼˤ	t̪͡θˤʼ
tθ̟	t̪͡θ̟
tθ̺	t̪͡θ̺
tθ̻	t̪͡θ̻
tθᶣ	t̪͡θᶣ
t̪ᶣ	t̪ᶣ
t̪ⁿ	t̪ⁿ
t̺	t̺
t̻	t̻
ts	t͡s
tsʰ	t͡sʰ
tsʲʰ	t͡sʲʰ
tsʷʰ	t͡sʷʰ
tsʰː	t͡sʰː
tsˠʰ	t͡sʰˠ
tsˤʰ	t͡sˤʰ
tsᶣʰ	t͡sʰᶣ
tsʲ	t͡sʲ
tsʲʷ	t͡sʲʷ
tsʲʷʰ	t͡sʲʷʰ
tsʼʲ	t͡sʼʲ
tsʲː	t͡sːʲ
tsʷ	t͡sʷ
tsʷʰː	t͡sʷʰː
tsʼʷ	t͡sʼʷ
tsʷˀ	t͡sʷˀ
tsʷː	t͡sːʷ
tsʷˠ	t͡sʷˠ
tsʷˠʰ	t͡sʷˠʰ
tsʷˤ	t͡sʷˤ
tsʷˤʰ	t͡sʷˤʰ
tsʼʷˤ	t͡sʷˤʼ
tsʼ	t͡sʼ
tsʼː	t͡sʼː
tsˀ	t͡sˀ
tsː	t͡sː
tsˠː	t͡sːˠ
tsˤː	t͡sˤː
tsˠ	t͡sˠ
tsˤ	t͡sˤ
tsʼˤ	t͡sˤʼ
ts̟	t͡s̟
ts̠	t͡s̠
ts̺	t͡s̺
ts̻	t͡s̻
tsᶣ	t͡sᶣ
tɕ	t͡ɕ
tɕʰ	t͡ɕʰ
tɕʲʰ	t͡ɕʲʰ
tɕʷʰ	t͡ɕʷʰ
tɕʰː	t͡ɕʰː
tɕˠʰ	t͡ɕʰˠ
tɕˤʰ	t͡ɕˤʰ
tɕᶣʰ	t͡ɕʰᶣ
tɕʲ	t͡ɕʲ
tɕʲʷ	t͡ɕʲʷ
tɕʲʷʰ	t͡ɕʲʷʰ
tɕʼʲ	t͡ɕʼʲ
tɕʲː	t͡ɕːʲ
tɕʷ	t͡ɕʷ
tɕʷʰː	t͡ɕʷʰː
tɕʼʷ	t͡ɕʼʷ
tɕʷˀ	t͡ɕʷˀ
tɕʷː	t͡ɕːʷ
tɕʷˠ	t͡ɕʷˠ
tɕʷˠʰ	t͡ɕʷˠʰ
tɕʷˤ	t͡ɕʷˤ
tɕʷˤʰ	t͡ɕʷˤʰ
tɕʼʷˤ	t͡ɕʷˤʼ
tɕʼ	t͡ɕʼ
tɕʼː	t͡ɕʼː
tɕˀ	t͡ɕˀ
tɕː	t͡ɕː
tɕˠː	t͡ɕːˠ
tɕˤː	t͡ɕˤː
tɕˠ	t͡ɕˠ
tɕˤ	t͡ɕˤ
tɕʼˤ	t͡ɕˤʼ
tɕ̟	t͡ɕ̟
tɕ̠	t͡ɕ̠
tɕ̺	t͡ɕ̺
tɕ̻	t͡ɕ̻
tɕᶣ	t͡ɕᶣ
tɬ	t͡ɬ
tɬʰ	t͡ɬʰ
tɬʲʰ	t͡ɬʲʰ
tɬʷʰ	t͡ɬʷʰ
tɬʰː	t͡ɬʰː
tɬˠʰ	t͡ɬʰˠ
tɬˤʰ	t͡ɬˤʰ
tɬᶣʰ	t͡ɬʰᶣ
tɬʲ	t͡ɬʲ
tɬʲʷ	t͡ɬʲʷ
tɬʲʷʰ	t͡ɬʲʷʰ
tɬʼʲ	t͡ɬʼʲ
tɬʲː	t͡ɬːʲ
tɬʷ	t͡ɬʷ
tɬʷʰː	t͡ɬʷʰː
tɬʼʷ	t͡ɬʼʷ
tɬʷˀ	t͡ɬʷˀ
tɬʷː	t͡ɬːʷ
tɬʷˠ	t͡ɬʷˠ
tɬʷˠʰ	t͡ɬʷˠʰ
tɬʷˤ	t͡ɬʷˤ
tɬʷˤʰ	t͡ɬʷˤʰ
tɬʼʷˤ	t͡ɬʷˤʼ
tɬʼ	t͡ɬʼ
tɬʼː	t͡ɬʼː
tɬˀ	t͡ɬˀ
tɬː	t͡ɬː
tɬˠː	t͡ɬːˠ
tɬˤː	t͡ɬˤː
tɬˠ	t͡ɬˠ
tɬˤ	t͡ɬˤ
tɬʼˤ	t͡ɬˤʼ
tɬ̟	t͡ɬ̟
tɬ̠	t͡ɬ̠
tɬ̺	t͡ɬ̺
tɬ̻	t͡ɬ̻
tɬᶣ	t͡ɬᶣ
tʃ	t͡ʃ
tʃʰ	t͡ʃʰ
tʃʲʰ	t͡ʃʲʰ
tʃʷʰ	t͡ʃʷʰ
tʃʰː	t͡ʃʰː
tʃˠʰ	t͡ʃʰˠ
tʃˤʰ	t͡ʃˤʰ
tʃᶣʰ	t͡ʃʰᶣ
tʃʲ	t͡ʃʲ
tʃʲʷ	t͡ʃʲʷ
tʃʲʷʰ	t͡ʃʲʷʰ
tʃʼʲ	t͡ʃʼʲ
tʃʲː	t͡ʃːʲ
tʃʷ	t͡ʃʷ
tʃʷʰː	t͡ʃʷʰː
tʃʼʷ	t͡ʃʼʷ
tʃʷˀ	t͡ʃʷˀ
tʃʷː	t͡ʃːʷ
tʃʷˠ	t͡ʃʷˠ
tʃʷˠʰ	t͡ʃʷˠʰ
tʃʷˤ	t͡ʃʷˤ
tʃʷˤʰ	t͡ʃʷˤʰ
tʃʼʷˤ	t͡ʃʷˤʼ
tʃʼ	t͡ʃʼ
tʃʼː	t͡ʃʼː
tʃˀ	t͡ʃˀ
tʃː	t͡ʃː
tʃˠː	t͡ʃːˠ
tʃˤː	t͡ʃˤː
tʃˠ	t͡ʃˠ
tʃˤ	t͡ʃˤ
tʃʼˤ	t͡ʃˤʼ
tʃ̟	t͡ʃ̟
tʃ̠	t͡ʃ̠
tʃ̺	t͡ʃ̺
tʃ̻	t͡ʃ̻
tʃᶣ	t͡ʃᶣ
tᶣ	tᶣ
tⁿ	tⁿ
u	u
uː	uː
uˤː	uˤː
u˞	u˞
uˤ	uˤ
u̘	u̘
u̘ː	u̘ː
u̙	u̙
u̙ː	u̙ː
u̝	u̝
u̞	u̞
u̟	u̟
u̠	u̠
u̥	u̥
u̥ː	u̥ː
u̥ˤ	u̥ˤ
u̯	u̯
v	v
vʲ	vʲ
vʲʷ	vʲʷ
vʲː	vːʲ
vʷ	vʷ
vʷˀ	vʷˀ
vʷː	vːʷ
vʷˠ	vʷˠ
vʷˤ	vʷˤ
vˀ	vˀ
vː	vː
vˠː	vːˠ
vˤː	vˤː
vˠ	vˠ
vˤ	vˤ
v̝	v̝
v̞	v̞
v̟	v̟
v̠	v̠
vʱ	v̤
vʲʱ	v̤ʲ
vʷʱ	v̤ʷ
vʱː	v̤ː
vˠʱ	v̤ˠ
vˤʱ	v̤ˤ
v̩	v̩
v̰	v̰
v̰ʲ	v̰ʲ
v̰ʷ	v̰ʷ
v̰ː	v̰ː
v̰ˠ	v̰ˠ
v̰ˤ	v̰ˤ
w	w
wʲ	wʲ
wʲʷ	wʲʷ
wʲː	wːʲ
wˀ	wˀ
wː	wː
wʷː	wːʷ
wˠː	wːˠ
wˤː	wˤː
wˠ	wˠ
wˤ	wˤ
w̃	w̃
w̃ː	w̃ː
w̃ˤ	w̃ˤ
w̝	w̝
w̞	w̞
w̟	w̟
w̠	w̠
wʱ	w̤
wʲʱ	w̤ʲ
wʷʱ	w̤ʷ
wʱː	w̤ː
wˠʱ	w̤ˠ
wˤʱ	w̤ˤ
w̥ʱ	w̤̥
w̥	w̥
w̥ʲ	w̥ʲ
w̥ʷ	w̥ʷ
w̥ː	w̥ː
w̥ˠ	w̥ˠ
w̥ˤ	w̥ˤ
w̩	w̩
w̰	w̰
w̰ʲ	w̰ʲ
w̰ʷ	w̰ʷ
w̰ː	w̰ː
w̰ˠ	w̰ˠ
w̰ˤ	w̰ˤ
w̰̃	w̰̃
x	x
xʰ	xʰ
xʲʰ	xʲʰ
xʷʰ	xʷʰ
xʰː	xʰː
xˠʰ	xʰˠ
xˤʰ	xˤʰ
xᶣʰ	xʰᶣ
xʲ	xʲ
xʲʷ	xʲʷ
xʲʷʰ	xʲʷʰ
xʼʲ	xʼʲ
xʲː	xːʲ
xʷ	xʷ
xʷʰː	xʷʰː
xʼʷ	xʼʷ
xʷˀ	xʷˀ
xʷː	xːʷ
xʷˠ	xʷˠ
xʷˠʰ	xʷˠʰ
xʷˤ	xʷˤ
xʷˤʰ	xʷˤʰ
xʼʷˤ	xʷˤʼ
xʼ	xʼ
xʼː	xʼː
xˀ	xˀ
xː	xː
xˠː	xːˠ
xˤː	xˤː
xˤ	xˤ
xʼˤ	xˤʼ
x̝	x̝
x̞	x̞
x̟	x̟
x̠	x̠
x̩	x̩
xᶣ	xᶣ
y	y
yː	yː
yˠː	yːˠ
yˤː	yˤː
y˞	y˞
yˠ	yˠ
yˤ	yˤ
y̆	y̆
y̘	y̘
y̘ː	y̘ː
y̘ˠ	y̘ˠ
y̙	y̙
y̙ː	y̙ː
y̙ˠ	y̙ˠ
y̝	y̝
y̞	y̞
y̟	y̟
y̠	y̠
y̤	y̤
y̤ː	y̤ː
y̤ˠ	y̤ˠ
y̤ˤ	y̤ˤ
y̥̤	y̤̥
y̥	y̥
y̥ː	y̥ː
y̥ˠ	y̥ˠ
y̥ˤ	y̥ˤ
y̯	y̯
y̰	y̰
y̰ː	y̰ː
y̰ˠ	y̰ˠ
y̰ˤ	y̰ˤ
z	z
zʲ	zʲ
zʲʷ	zʲʷ
zʲː	zːʲ
zʷ	zʷ
zʷˀ	zʷˀ
zʷː	zːʷ
zʷˠ	zʷˠ
zʷˤ	zʷˤ
zˀ	zˀ
zː	zː
zˠː	zːˠ
zˤː	zˤː
zˠ	zˠ
zˤ	zˤ
z̃	z̃
z̃ː	z̃ː
z̃ˤ	z̃ˤ
z̝	z̝
z̞	z̞
z̟	z̟
z̠	z̠
zʱ	z̤
zʲʱ	z̤ʲ
zʷʱ	z̤ʷ
zʱː	z̤ː
zˠʱ	z̤ˠ
zˤʱ	z̤ˤ
z̩	z̩
z̪	z̪
z̪ʲ	z̪ʲ
z̪ʲʷ	z̪ʲʷ
z̪ʲː	z̪ːʲ
z̪ʷ	z̪ʷ
z̪ʷˀ	z̪ʷˀ
z̪ʷː	z̪ːʷ
z̪ʷˠ	z̪ʷˠ
z̪ʷˤ	z̪ʷˤ
z̪ˀ	z̪ˀ
z̪ː	z̪ː
z̪ˠː	z̪ːˠ
z̪ˤː	z̪ˤː
z̪ˠ	z̪ˠ
z̪ˤ	z̪ˤ
z̪̃	z̪̃
z̪̃ː	z̪̃ː
z̪̃ˤ	z̪̃ˤ
z̪̝	z̪̝
z̪̞	z̪̞
z̪̟	z̪̟
z̪̠	z̪̠
z̪ʱ	z̪̤
z̪ʲʱ	z̪̤ʲ
z̪ʷʱ	z̪̤ʷ
z̪ʱː	z̪̤ː
z̪ˠʱ	z̪̤ˠ
z̪ˤʱ	z̪̤ˤ
z̪̩	z̪̩
z̪̰	z̪̰
z̪̰ʲ	z̪̰ʲ
z̪̰ʷ	z̪̰ʷ
z̪̰ː	z̪̰ː
z̪̰ˠ	z̪̰ˠ
z̪̰ˤ	z̪̰ˤ
z̪̰̃	z̪̰̃
z̪̺	z̪̺
z̪̻	z̪̻
z̪ᶣ	z̪ᶣ
z̰	z̰
z̰ʲ	z̰ʲ
z̰ʷ	z̰ʷ
z̰ː	z̰ː
z̰ˠ	z̰ˠ
z̰ˤ	z̰ˤ
z̰̃	z̰̃
z̺	z̺
zᶣ	zᶣ
ã	ã
ãː	ãː
ãˤ	ãˤ
ã̰	ã̰
ä	ä
æ	æ
æː	æː
æˠː	æːˠ
æˤː	æˤː
æ˞	æ˞
æˠ	æˠ
æˤ	æˤ
æ̃	æ̃
æ̃ː	æ̃ː
æ̃ˤ	æ̃ˤ
æ̆	æ̆
æ̈	æ̈
æ̘	æ̘
æ̘ː	æ̘ː
æ̘ˠ	æ̘ˠ
æ̙	æ̙
æ̙ː	æ̙ː
æ̙ˠ	æ̙ˠ
æ̝	æ̝
æ̞	æ̞
æ̟	æ̟
æ̠	æ̠
æ̤	æ̤
æ̤ː	æ̤ː
æ̤ˠ	æ̤ˠ
æ̤ˤ	æ̤ˤ
æ̥̤	æ̤̥
æ̥	æ̥
æ̥ː	æ̥ː
æ̥ˠ	æ̥ˠ
æ̥ˤ	æ̥ˤ
æ̯	æ̯
æ̰	æ̰
æ̰ː	æ̰ː
æ̰ˠ	æ̰ˠ
æ̰ˤ	æ̰ˤ
æ̰̃	æ̰̃
ç	ç
çʰ	çʰ
çʲʰ	çʲʰ
çʷʰ	çʷʰ
çʰː	çʰː
çˠʰ	çʰˠ
çˤʰ	çˤʰ
çᶣʰ	çʰᶣ
çʲ	çʲ
çʲʷ	çʲʷ
çʲʷʰ	çʲʷʰ
çʼʲ	çʼʲ
çʲː	çːʲ
çʷ	çʷ
çʷʰː	çʷʰː
çʼʷ	çʼʷ
çʷˀ	çʷˀ
çʷː	çːʷ
çʷˠ	çʷˠ
çʷˠʰ	çʷˠʰ
çʷˤ	çʷˤ
çʷˤʰ	çʷˤʰ
çʼʷˤ	çʷˤʼ
çʼ	çʼ
çʼː	çʼː
çˀ	çˀ
çː	çː
çˠː	çːˠ
çˤː	çˤː
çˠ	çˠ
çˤ	çˤ
çʼˤ	çˤʼ
ç̝	ç̝
ç̞	ç̞
ç̟	ç̟
ç̠	ç̠
ç̩	ç̩
çᶣ	çᶣ
ë	ë
ï	ï
ð	ð
ðʲ	ðʲ
ðʲʷ	ðʲʷ
ðʲː	ðːʲ
ðʷ	ðʷ
ðʷˀ	ðʷˀ
ðʷː	ðːʷ
ðʷˠ	ðʷˠ
ðʷˤ	ðʷˤ
ðˀ	ðˀ
ðː	ðː
ðˠː	ðːˠ
ðˤː	ðˤː
ðˠ	ðˠ
ðˤ	ðˤ
ð̃	ð̃
ð̃ː	ð̃ː
ð̃ˤ	ð̃ˤ
ð̝	ð̝
ɹ̪	ð̞
ð̟	ð̟
ð̠	ð̠
ðʱ	ð̤
ðʲʱ	ð̤ʲ
ðʷʱ	ð̤ʷ
ðʱː	ð̤ː
ðˠʱ	ð̤ˠ
ðˤʱ	ð̤ˤ
ð̩	ð̩
ð̰	ð̰
ð̰ʲ	ð̰ʲ
ð̰ʷ	ð̰ʷ
ð̰ː	ð̰ː
ð̰ˠ	ð̰ˠ
ð̰ˤ	ð̰ˤ
ð̰̃	ð̰̃
ð̺	ð̺
ð̻	ð̻
ðᶣ	ðᶣ
õ	õ
õː	õː
õˤ	õˤ
õ̰	õ̰
ö	ö
ø	ø
øː	øː
øˠː	øːˠ
øˤː	øˤː
ø˞	ø˞
øˠ	øˠ
øˤ	øˤ
ø̃	ø̃
ø̃ː	ø̃ː
ø̃ˤ	ø̃ˤ
ø̆	ø̆
ø̈	ø̈
ø̘	ø̘
ø̘ː	ø̘ː
ø̘ˠ	ø̘ˠ
ø̙	ø̙
ø̙ː	ø̙ː
ø̙ˠ	ø̙ˠ
ø̝	ø̝
ø̞	ø̞
ø̟	ø̟
ø̠	ø̠
ø̤	ø̤
ø̤ː	ø̤ː
ø̤ˠ	ø̤ˠ
ø̤ˤ	ø̤ˤ
ø̥̤	ø̤̥
ø̥	ø̥
ø̥ː	ø̥ː
ø̥ˠ	ø̥ˠ
ø̥ˤ	ø̥ˤ
ø̯	ø̯
ø̰	ø̰
ø̰ː	ø̰ː
ø̰ˠ	ø̰ˠ
ø̰ˤ	ø̰ˤ
ø̰̃	ø̰̃
ü	ü
ÿ	ÿ
ă	ă
ĕ	ĕ
ħ	ħ
ħʰ	ħʰ
ħʲʰ	ħʲʰ
ħʷʰ	ħʷʰ
ħʰː	ħʰː
ħˠʰ	ħʰˠ
ħˤʰ	ħʰˤ
ħᶣʰ	ħʰᶣ
ħʲ	ħʲ
ħʲʷ	ħʲʷ
ħʲʷʰ	ħʲʷʰ
ħʼʲ	ħʼʲ
ħʲː	ħːʲ
ħʷ	ħʷ
ħʷʰː	ħʷʰː
ħʼʷ	ħʼʷ
ħʷˀ	ħʷˀ
ħʷː	ħːʷ
ħʷˠ	ħʷˠ
ħʷˠʰ	ħʷˠʰ
ħʷˤ	ħʷˤ
ħʷˤʰ	ħʷˤʰ
ħʼʷˤ	ħʷˤʼ
ħʼ	ħʼ
ħʼː	ħʼː
ħˀ	ħˀ
ħː	ħː
ħˠː	ħːˠ
ħˤː	ħːˤ
ħˠ	ħˠ
ħ̝	ħ̝
ħ̞	ħ̞
ħ̟	ħ̟
ħ̠	ħ̠
ħ̩	ħ̩
ħᶣ	ħᶣ
ĩ	ĩ
ĩː	ĩː
ĩˤ	ĩˤ
ĭ	ĭ
ŋ	ŋ
ŋʲ	ŋʲ
ŋʲʷ	ŋʲʷ
ŋʲː	ŋːʲ
ŋʷ	ŋʷ
ŋʷˀ	ŋʷˀ
ŋʷː	ŋːʷ
ŋʷˠ	ŋʷˠ
ŋʷˤ	ŋʷˤ
ŋˀ	ŋˀ
ŋː	ŋː
ŋˠː	ŋːˠ
ŋˤː	ŋˤː
ŋˤ	ŋˤ
ŋ̟	ŋ̟
ŋ̠	ŋ̠
ŋʱ	ŋ̤
ŋʲʱ	ŋ̤ʲ
ŋʷʱ	ŋ̤ʷ
ŋʱː	ŋ̤ː
ŋˠʱ	ŋ̤ˠ
ŋˤʱ	ŋ̤ˤ
ŋ̥ʱ	ŋ̤̥
ŋ̊	ŋ̥
ŋ̥ʲ	ŋ̥ʲ
ŋ̥ʷ	ŋ̥ʷ
ŋ̥ː	ŋ̥ː
ŋ̥ˠ	ŋ̥ˠ
ŋ̥ˤ	ŋ̥ˤ
ŋ̍	ŋ̩
ŋ̰	ŋ̰
ŋ̰ʲ	ŋ̰ʲ
ŋ̰ʷ	ŋ̰ʷ
ŋ̰ː	ŋ̰ː
ŋ̰ˠ	ŋ̰ˠ
ŋ̰ˤ	ŋ̰ˤ
ŋᶣ	ŋᶣ
ŏ	ŏ
œ	œ
œː	œː
œˠː	œːˠ
œˤː	œˤː
œ˞	œ˞
œˠ	œˠ
œˤ	œˤ
œ̃	œ̃
œ̃ː	œ̃ː
œ̃ˤ	œ̃ˤ
œ̆	œ̆
œ̈	œ̈
œ̘	œ̘
œ̘ː	œ̘ː
œ̘ˠ	œ̘ˠ
œ̙	œ̙
œ̙ː	œ̙ː
œ̙ˠ	œ̙ˠ
œ̝	œ̝
œ̞	œ̞
œ̟	œ̟
œ̠	œ̠
œ̤	œ̤
œ̤ː	œ̤ː
œ̤ˠ	œ̤ˠ
œ̤ˤ	œ̤ˤ
œ̥̤	œ̤̥
œ̥	œ̥
œ̥ː	œ̥ː
œ̥ˠ	œ̥ˠ
œ̥ˤ	œ̥ˤ
œ̯	œ̯
œ̰	œ̰
œ̰ː	œ̰ː
œ̰ˠ	œ̰ˠ
œ̰ˤ	œ̰ˤ
œ̰̃	œ̰̃
ũ	ũ
ũː	ũː
ũˤ	ũˤ
ŭ	ŭ
ǀ	ǀ
ǀʰ	ǀʰ
ǀʲʰ	ǀʲʰ
ǀʷʰ	ǀʷʰ
ǀʰː	ǀʰː
ǀˠʰ	ǀʰˠ
ǀˤʰ	ǀˤʰ
ǀᶣʰ	ǀʰᶣ
ǀʲ	ǀʲ
ǀʲʷ	ǀʲʷ
ǀʲʷʰ	ǀʲʷʰ
ǀʼʲ	ǀʼʲ
ǀʲː	ǀːʲ
ǀʷ	ǀʷ
ǀʷʰː	ǀʷʰː
ǀʼʷ	ǀʼʷ
ǀʷˀ	ǀʷˀ
ǀʷː	ǀːʷ
ǀʷˠ	ǀʷˠ
ǀʷˠʰ	ǀʷˠʰ
ǀʷˤ	ǀʷˤ
ǀʷˤʰ	ǀʷˤʰ
ǀʼʷˤ	ǀʷˤʼ
ǀʼ	ǀʼ
ǀʼː	ǀʼː
ǀˀ	ǀˀ
ǀː	ǀː
ǀˠː	ǀːˠ
ǀˤː	ǀˤː
ǀˠ	ǀˠ
ǀˡ	ǀˡ
ǀˤ	ǀˤ
ǀʼˤ	ǀˤʼ
ǀ̟	ǀ̟
ǀ̠	ǀ̠
ǀ̺	ǀ̺
ǀ̻	ǀ̻
ǀᶣ	ǀᶣ
ǀⁿ	ǀⁿ
ǁ	ǁ
ǁʰ	ǁʰ
ǁʲʰ	ǁʲʰ
ǁʷʰ	ǁʷʰ
ǁʰː	ǁʰː
ǁˠʰ	ǁʰˠ
ǁˤʰ	ǁˤʰ
ǁᶣʰ	ǁʰᶣ
ǁʲ	ǁʲ
ǁʲʷ	ǁʲʷ
ǁʲʷʰ	ǁʲʷʰ
ǁʲː	ǁːʲ
ǁʷ	ǁʷ
ǁʷʰː	ǁʷʰː
ǁʷˀ	ǁʷˀ
ǁʷː	ǁːʷ
ǁʷˠ	ǁʷˠ
ǁʷˠʰ	ǁʷˠʰ
ǁʷˤ	ǁʷˤ
ǁʷˤʰ	ǁʷˤʰ
ǁˀ	ǁˀ
ǁː	ǁː
ǁˠː	ǁːˠ
ǁˤː	ǁˤː
ǁˠ	ǁˠ
ǁˡ	ǁˡ
ǁˤ	ǁˤ
ǁ̟	ǁ̟
ǁ̠	ǁ̠
ǁ̃	ǁ̴
ǁ̺	ǁ̺
ǁ̻	ǁ̻
ǁᶣ	ǁᶣ
ǁⁿ	ǁⁿ
ǂ	ǂ
ǂʰ	ǂʰ
ǂʲʰ	ǂʲʰ
ǂʷʰ	ǂʷʰ
ǂʰː	ǂʰː
ǂˠʰ	ǂʰˠ
ǂˤʰ	ǂˤʰ
ǂᶣʰ	ǂʰᶣ
ǂʲ	ǂʲ
ǂʲʷ	ǂʲʷ
ǂʲʷʰ	ǂʲʷʰ
ǂʼʲ	ǂʼʲ
ǂʲː	ǂːʲ
ǂʷ	ǂʷ
ǂʷʰː	ǂʷʰː
ǂʼʷ	ǂʼʷ
ǂʷˀ	ǂʷˀ
ǂʷː	ǂːʷ
ǂʷˠ	ǂʷˠ
ǂʷˠʰ	ǂʷˠʰ
ǂʷˤ	ǂʷˤ
ǂʷˤʰ	ǂʷˤʰ
ǂʼʷˤ	ǂʷˤʼ
ǂʼ	ǂʼ
ǂʼː	ǂʼː
ǂˀ	ǂˀ
ǂː	ǂː
ǂˠː	ǂːˠ
ǂˤː	ǂˤː
ǂˠ	ǂˠ
ǂˡ	ǂˡ
ǂˤ	ǂˤ
ǂʼˤ	ǂˤʼ
ǂ̟	ǂ̟
ǂ̠	ǂ̠
ǂ̺	ǂ̺
ǂ̻	ǂ̻
ǂᶣ	ǂᶣ
ǂⁿ	ǂⁿ
ǃ	ǃ
ǃʰ	ǃʰ
ǃʲʰ	ǃʲʰ
ǃʷʰ	ǃʷʰ
ǃʰː	ǃʰː
ǃˠʰ	ǃʰˠ
ǃˤʰ	ǃˤʰ
ǃᶣʰ	ǃʰᶣ
ǃʲ	ǃʲ
ǃʲʷ	ǃʲʷ
ǃʲʷʰ	ǃʲʷʰ
ǃʼʲ	ǃʼʲ
ǃʲː	ǃːʲ
ǃʷ	ǃʷ
ǃʷʰː	ǃʷʰː
ǃʼʷ	ǃʼʷ
ǃʷˀ	ǃʷˀ
ǃʷː	ǃːʷ
ǃʷˠ	ǃʷˠ
ǃʷˠʰ	ǃʷˠʰ
ǃʷˤ	ǃʷˤ
ǃʷˤʰ	ǃʷˤʰ
ǃʼʷˤ	ǃʷˤʼ
ǃʼ	ǃʼ
ǃʼː	ǃʼː
ǃˀ	ǃˀ
ǃː	ǃː
ǃˠː	ǃːˠ
ǃˤː	ǃˤː
ǃˠ	ǃˠ
ǃˡ	ǃˡ
ǃˤ	ǃˤ
ǃʼˤ	ǃˤʼ
ǃ̟	ǃ̟
ǃ̠	ǃ̠
ǃ̺	ǃ̺
ǃ̻	ǃ̻
ǃᶣ	ǃᶣ
ǃⁿ	ǃⁿ
ɐ	ɐ
ɐː	ɐː
ɐˠː	ɐːˠ
ɐˤː	ɐˤː
ɐ˞	ɐ˞
ɐˠ	ɐˠ
ɐˤ	ɐˤ
ɐ̃	ɐ̃
ɐ̃ː	ɐ̃ː
ɐ̃ˤ	ɐ̃ˤ
ɐ̆	ɐ̆
ɐ̈	ɐ̈
ɐ̘	ɐ̘
ɐ̘ː	ɐ̘ː
ɐ̘ˠ	ɐ̘ˠ
ɐ̙	ɐ̙
ɐ̙ː	ɐ̙ː
ɐ̙ˠ	ɐ̙ˠ
ɐ̝	ɐ̝
ɐ̞	ɐ̞
ɐ̟	ɐ̟
ɐ̠	ɐ̠
ɐ̤	ɐ̤
ɐ̤ː	ɐ̤ː
ɐ̤ˠ	ɐ̤ˠ
ɐ̤ˤ	ɐ̤ˤ
ɐ̥̤	ɐ̤̥
ɐ̥	ɐ̥
ɐ̥ː	ɐ̥ː
ɐ̥ˠ	ɐ̥ˠ
ɐ̥ˤ	ɐ̥ˤ
ɐ̯	ɐ̯
ɐ̰	ɐ̰
ɐ̰ː	ɐ̰ː
ɐ̰ˠ	ɐ̰ˠ
ɐ̰ˤ	ɐ̰ˤ
ɐ̰̃	ɐ̰̃
ɑ	ɑ
ɑː	ɑː
ɑˠː	ɑːˠ
ɑˤː	ɑˤː
ɑ˞	ɑ˞
ɑˠ	ɑˠ
ɑˤ	ɑˤ
ɑ̃	ɑ̃
ɑ̃ː	ɑ̃ː
ɑ̃ˤ	ɑ̃ˤ
ɑ̆	ɑ̆
ɑ̈	ɑ̈
ɑ̘	ɑ̘
ɑ̘ː	ɑ̘ː
ɑ̘ˠ	ɑ̘ˠ
ɑ̙	ɑ̙
ɑ̙ː	ɑ̙ː
ɑ̙ˠ	ɑ̙ˠ
ɑ̝	ɑ̝
ɑ̞	ɑ̞
ɑ̟	ɑ̟
ɑ̠	ɑ̠
ɑ̤	ɑ̤
ɑ̤ː	ɑ̤ː
ɑ̤ˠ	ɑ̤ˠ
ɑ̤ˤ	ɑ̤ˤ
ɑ̥̤	ɑ̤̥
ɑ̥	ɑ̥
ɑ̥ː	ɑ̥ː
ɑ̥ˠ	ɑ̥ˠ
ɑ̥ˤ	ɑ̥ˤ
ɑ̯	ɑ̯
ɑ̰	ɑ̰
ɑ̰ː	ɑ̰ː
ɑ̰ˠ	ɑ̰ˠ
ɑ̰ˤ	ɑ̰ˤ
ɑ̰̃	ɑ̰̃
ɒ	ɒ
ɒː	ɒː
ɒˠː	ɒːˠ
ɒˤː	ɒˤː
ɒ˞	ɒ˞
ɒˠ	ɒˠ
ɒˤ	ɒˤ
ɒ̃	ɒ̃
ɒ̃ː	ɒ̃ː
ɒ̃ˤ	ɒ̃ˤ
ɒ̆	ɒ̆
ɒ̈	ɒ̈
ɒ̘	ɒ̘
ɒ̘ː	ɒ̘ː
ɒ̘ˠ	ɒ̘ˠ
ɒ̙	ɒ̙
ɒ̙ː	ɒ̙ː
ɒ̙ˠ	ɒ̙ˠ
ɒ̝	ɒ̝
ɒ̞	ɒ̞
ɒ̟	ɒ̟
ɒ̠	ɒ̠
ɒ̤	ɒ̤
ɒ̤ː	ɒ̤ː
ɒ̤ˠ	ɒ̤ˠ
ɒ̤ˤ	ɒ̤ˤ
ɒ̥̤	ɒ̤̥
ɒ̥	ɒ̥
ɒ̥ː	ɒ̥ː
ɒ̥ˠ	ɒ̥ˠ
ɒ̥ˤ	ɒ̥ˤ
ɒ̯	ɒ̯
ɒ̰	ɒ̰
ɒ̰ː	ɒ̰ː
ɒ̰ˠ	ɒ̰ˠ
ɒ̰ˤ	ɒ̰ˤ
ɒ̰̃	ɒ̰̃
ɓ	ɓ
ɓʲ	ɓʲ
ɓʲʷ	ɓʲʷ
ɓʲː	ɓːʲ
ɓʷ	ɓʷ
ɓʷː	ɓːʷ
ɓʷˠ	ɓʷˠ
ɓʷˤ	ɓʷˤ
ɓː	ɓː
ɓˠː	ɓːˠ
ɓˤː	ɓˤː
ɓˠ	ɓˠ
ɓˤ	ɓˤ
ɓ̃	ɓ̃
ɓ̃ː	ɓ̃ː
ɓ̃ˤ	ɓ̃ˤ
ɓ̟	ɓ̟
ɓ̠	ɓ̠
ɓʱ	ɓ̤
ɓʲʱ	ɓ̤ʲ
ɓʷʱ	ɓ̤ʷ
ɓʱː	ɓ̤ː
ɓˠʱ	ɓ̤ˠ
ɓˤʱ	ɓ̤ˤ
ɓ̰	ɓ̰
ɓ̰ʲ	ɓ̰ʲ
ɓ̰ʷ	ɓ̰ʷ
ɓ̰ː	ɓ̰ː
ɓ̰ˠ	ɓ̰ˠ
ɓ̰ˤ	ɓ̰ˤ
ɓ̰̃	ɓ̰̃
ɓⁿ	ɓⁿ
ɔ	ɔ
ɔː	ɔː
ɔˠː	ɔːˠ
ɔˤː	ɔˤː
ɔ˞	ɔ˞
ɔˠ	ɔˠ
ɔˤ	ɔˤ
ɔ̃	ɔ̃
ɔ̃ː	ɔ̃ː
ɔ̃ˤ	ɔ̃ˤ
ɔ̆	ɔ̆
ɔ̈	ɔ̈
ɔ̘	ɔ̘
ɔ̘ː	ɔ̘ː
ɔ̘ˠ	ɔ̘ˠ
ɔ̙	ɔ̙
ɔ̙ː	ɔ̙ː
ɔ̙ˠ	ɔ̙ˠ
ɔ̝	ɔ̝
ɔ̞	ɔ̞
ɔ̟	ɔ̟
ɔ̠	ɔ̠
ɔ̤	ɔ̤
ɔ̤ː	ɔ̤ː
ɔ̤ˠ	ɔ̤ˠ
ɔ̤ˤ	ɔ̤ˤ
ɔ̥̤	ɔ̤̥
ɔ̥	ɔ̥
ɔ̥ː	ɔ̥ː
ɔ̥ˠ	ɔ̥ˠ
ɔ̥ˤ	ɔ̥ˤ
ɔ̯	ɔ̯
ɔ̰	ɔ̰
ɔ̰ː	ɔ̰ː
ɔ̰ˠ	ɔ̰ˠ
ɔ̰ˤ	ɔ̰ˤ
ɔ̰̃	ɔ̰̃
ɕ	ɕ
ɕʰ	ɕʰ
ɕʲʰ	ɕʲʰ
ɕʷʰ	ɕʷʰ
ɕʰː	ɕʰː
ɕˠʰ	ɕʰˠ
ɕˤʰ	ɕˤʰ
ɕᶣʰ	ɕʰᶣ
ɕʲ	ɕʲ
ɕʲʷ	ɕʲʷ
ɕʲʷʰ	ɕʲʷʰ
ɕʼʲ	ɕʼʲ
ɕʲː	ɕːʲ
ɕʷ	ɕʷ
ɕʷʰː	ɕʷʰː
ɕʼʷ	ɕʼʷ
ɕʷˀ	ɕʷˀ
ɕʷː	ɕːʷ
ɕʷˠ	ɕʷˠ
ɕʷˠʰ	ɕʷˠʰ
ɕʷˤ	ɕʷˤ
ɕʷˤʰ	ɕʷˤʰ
ɕʼʷˤ	ɕʷˤʼ
ɕʼ	ɕʼ
ɕʼː	ɕʼː
ɕˀ	ɕˀ
ɕː	ɕː
ɕˠː	ɕːˠ
ɕˤː	ɕˤː
ɕˠ	ɕˠ
ɕˤ	ɕˤ
ɕʼˤ	ɕˤʼ
ɕ̝	ɕ̝
ɕ̞	ɕ̞
ɕ̟	ɕ̟
ɕ̠	ɕ̠
ɕ̺	ɕ̺
ɕ̻	ɕ̻
ɕᶣ	ɕᶣ
ɖ	ɖ
ɖʰ	ɖʰ
ɖʲʰ	ɖʲʰ
ɖʷʰ	ɖʷʰ
ɖʰː	ɖʰː
ɖˠʰ	ɖʰˠ
ɖˤʰ	ɖˤʰ
ɖᶣʰ	ɖʰᶣ
ɖʲ	ɖʲ
ɖʲʷ	ɖʲʷ
ɖʲʷʰ	ɖʲʷʰ
ɖʲː	ɖːʲ
ɖʷ	ɖʷ
ɖʷʰː	ɖʷʰː
ɖʷˀ	ɖʷˀ
ɖʷː	ɖːʷ
ɖʷˠ	ɖʷˠ
ɖʷˠʰ	ɖʷˠʰ
ɖʷˤ	ɖʷˤ
ɖʷˤʰ	ɖʷˤʰ
ɖˀ	ɖˀ
ɖː	ɖː
ɖˠː	ɖːˠ
ɖˤː	ɖˤː
ɖˠ	ɖˠ
ɖˡ	ɖˡ
ɖˤ	ɖˤ
ɖ̃	ɖ̃
ɖ̃ː	ɖ̃ː
ɖ̃ˤ	ɖ̃ˤ
ɖ̟	ɖ̟
ɖ̠	ɖ̠
ɖʱ	ɖ̤
ɖʲʱ	ɖ̤ʲ
ɖʷʱ	ɖ̤ʷ
ɖʱː	ɖ̤ː
ɖˠʱ	ɖ̤ˠ
ɖˤʱ	ɖ̤ˤ
ɖ̰	ɖ̰
ɖ̰ʲ	ɖ̰ʲ
ɖ̰ʷ	ɖ̰ʷ
ɖ̰ː	ɖ̰ː
ɖ̰ˠ	ɖ̰ˠ
ɖ̰ˤ	ɖ̰ˤ
ɖ̰̃	ɖ̰̃
ɖ̺	ɖ̺
ɖ̻	ɖ̻
ɖʐ	ɖ͡ʐ
ɖʐʰ	ɖ͡ʐʰ
ɖʐʲʰ	ɖ͡ʐʲʰ
ɖʐʷʰ	ɖ͡ʐʷʰ
ɖʐʰː	ɖ͡ʐʰː
ɖʐˠʰ	ɖ͡ʐʰˠ
ɖʐˤʰ	ɖ͡ʐˤʰ
ɖʐᶣʰ	ɖ͡ʐʰᶣ
ɖʐʲ	ɖ͡ʐʲ
ɖʐʲʷ	ɖ͡ʐʲʷ
ɖʐʲʷʰ	ɖ͡ʐʲʷʰ
ɖʐʲː	ʈ͡ʂːʲ
ɖʐʷ	ɖ͡ʐʷ
ɖʐʷʰː	ɖ͡ʐʷʰː
ɖʐʷˀ	ɖ͡ʐʷˀ
ɖʐʷː	ʈ͡ʂːʷ
ɖʐʷˠ	ɖ͡ʐʷˠ
ɖʐʷˠʰ	ɖ͡ʐʷˠʰ
ɖʐʷˤ	ɖ͡ʐʷˤ
ɖʐʷˤʰ	ɖ͡ʐʷˤʰ
ɖʐˀ	ɖ͡ʐˀ
ɖʐː	ɖ͡ʐː
ɖʐˠː	ʈ͡ʂːˠ
ɖʐˤː	ʈ͡ʂːˤ
ɖʐˠ	ɖ͡ʐˠ
ɖʐˤ	ɖ͡ʐˤ
ɖʐ̃	ɖ͡ʐ̃
ɖʐ̃ː	ɖ͡ʐ̃ː
ɖʐ̃ˤ	ɖ͡ʐ̃ˤ
ɖʐ̟	ɖ͡ʐ̟
ɖʐ̠	ɖ͡ʐ̠
ɖʐʱ	ɖ͡ʐ̤
ɖʐʲʱ	ɖ͡ʐ̤ʲ
ɖʐʷʱ	ɖ͡ʐ̤ʷ
ɖʐʱː	ɖ͡ʐ̤ː
ɖʐˠʱ	ɖ͡ʐ̤ˠ
ɖʐˤʱ	ɖ͡ʐ̤ˤ
ɖʐ̰	ɖ͡ʐ̰
ɖʐ̰ʲ	ɖ͡ʐ̰ʲ
ɖʐ̰ʷ	ɖ͡ʐ̰ʷ
ɖʐ̰ː	ɖ͡ʐ̰ː
ɖʐ̰ˠ	ɖ͡ʐ̰ˠ
ɖʐ̰ˤ	ɖ͡ʐ̰ˤ
ɖʐ̰̃	ɖ͡ʐ̰̃
ɖʐ̺	ɖ͡ʐ̺
ɖʐ̻	ɖ͡ʐ̻
ɖʐᶣ	ɖ͡ʐᶣ
ɖᶣ	ɖᶣ
ɖⁿ	ɖⁿ
ɗ	ɗ
ɗʲ	ɗʲ
ɗʲʷ	ɗʲʷ
ɗʲː	ɗːʲ
ɗʷ	ɗʷ
ɗʷː	ɗːʷ
ɗʷˠ	ɗʷˠ
ɗʷˤ	ɗʷˤ
ɗː	ɗː
ɗˠː	ɗːˠ
ɗˤː	ɗˤː
ɗˠ	ɗˠ
ɗˡ	ɗˡ
ɗˤ	ɗˤ
ɗ̃	ɗ̃
ɗ̃ː	ɗ̃ː
ɗ̃ˤ	ɗ̃ˤ
ɗ̟	ɗ̟
ɗ̠	ɗ̠
ɗʱ	ɗ̤
ɗʲʱ	ɗ̤ʲ
ɗʷʱ	ɗ̤ʷ
ɗʱː	ɗ̤ː
ɗˠʱ	ɗ̤ˠ
ɗˤʱ	ɗ̤ˤ
ɗ̰	ɗ̰
ɗ̰ʲ	ɗ̰ʲ
ɗ̰ʷ	ɗ̰ʷ
ɗ̰ː	ɗ̰ː
ɗ̰ˠ	ɗ̰ˠ
ɗ̰ˤ	ɗ̰ˤ
ɗ̰̃	ɗ̰̃
ɗ̺	ɗ̺
ɗ̻	ɗ̻
ɗ̼	ɗ̼
ɗᶣ	ɗᶣ
ɗⁿ	ɗⁿ
ɘ	ɘ
ɘː	ɘː
ɘˠː	ɘːˠ
ɘˤː	ɘˤː
ɘ˞	ɘ˞
ɘˠ	ɘˠ
ɘˤ	ɘˤ
ɘ̃	ɘ̃
ɘ̃ː	ɘ̃ː
ɘ̃ˤ	ɘ̃ˤ
ɘ̆	ɘ̆
ɘ̈	ɘ̈
ɘ̘	ɘ̘
ɘ̘ː	ɘ̘ː
ɘ̘ˠ	ɘ̘ˠ
ɘ̙	ɘ̙
ɘ̙ː	ɘ̙ː
ɘ̙ˠ	ɘ̙ˠ
ɘ̝	ɘ̝
ɘ̞	ɘ̞
ɘ̟	ɘ̟
ɘ̠	ɘ̠
ɘ̤	ɘ̤
ɘ̤ː	ɘ̤ː
ɘ̤ˠ	ɘ̤ˠ
ɘ̤ˤ	ɘ̤ˤ
ɘ̥̤	ɘ̤̥
ɘ̥	ɘ̥
ɘ̥ː	ɘ̥ː
ɘ̥ˠ	ɘ̥ˠ
ɘ̥ˤ	ɘ̥ˤ
ɘ̯	ɘ̯
ɘ̰	ɘ̰
ɘ̰ː	ɘ̰ː
ɘ̰ˠ	ɘ̰ˠ
ɘ̰ˤ	ɘ̰ˤ
ɘ̰̃	ɘ̰̃
ə	ə
əː	əː
əˠː	əːˠ
əˤː	əˤː
ə˞	ə˞
əˠ	əˠ
əˤ	əˤ
ə̃	ə̃
ə̃ː	ə̃ː
ə̃ˤ	ə̃ˤ
ə̆	ə̆
ə̘	ə̘
ə̘ː	ə̘ː
ə̘ˠ	ə̘ˠ
ə̙	ə̙
ə̙ː	ə̙ː
ə̙ˠ	ə̙ˠ
ə̝	ə̝
ə̞	ə̞
ə̟	ə̟
ə̠	ə̠
ə̤	ə̤
ə̤ː	ə̤ː
ə̤ˠ	ə̤ˠ
ə̤ˤ	ə̤ˤ
ə̥̤	ə̤̥
ə̥	ə̥
ə̥ː	ə̥ː
ə̥ˠ	ə̥ˠ
ə̥ˤ	ə̥ˤ
ə̯	ə̯
ə̰	ə̰
ə̰ː	ə̰ː
ə̰ˠ	ə̰ˠ
ə̰ˤ	ə̰ˤ
ə̰̃	ə̰̃
ɛ	ɛ
ɛː	ɛː
ɛˠː	ɛːˠ
ɛˤː	ɛˤː
ɛ˞	ɛ˞
ɛˠ	ɛˠ
ɛˤ	ɛˤ
ɛ̃	ɛ̃
ɛ̃ː	ɛ̃ː
ɛ̃ˤ	ɛ̃ˤ
ɛ̆	ɛ̆
ɛ̈	ɛ̈
ɛ̘	ɛ̘
ɛ̘ː	ɛ̘ː
ɛ̘ˠ	ɛ̘ˠ
ɛ̙	ɛ̙
ɛ̙ː	ɛ̙ː
ɛ̙ˠ	ɛ̙ˠ
ɛ̝	ɛ̝
ɛ̞	ɛ̞
ɛ̟	ɛ̟
ɛ̠	ɛ̠
ɛ̤	ɛ̤
ɛ̤ː	ɛ̤ː
ɛ̤ˠ	ɛ̤ˠ
ɛ̤ˤ	ɛ̤ˤ
ɛ̥̤	ɛ̤̥
ɛ̥	ɛ̥
ɛ̥ː	ɛ̥ː
ɛ̥ˠ	ɛ̥ˠ
ɛ̥ˤ	ɛ̥ˤ
ɛ̯	ɛ̯
ɛ̰	ɛ̰
ɛ̰ː	ɛ̰ː
ɛ̰ˠ	ɛ̰ˠ
ɛ̰ˤ	ɛ̰ˤ
ɛ̰̃	ɛ̰̃
ɜ	ɜ
ɜː	ɜː
ɜˠː	ɜːˠ
ɜˤː	ɜˤː
ɜ˞	ɜ˞
ɜˠ	ɜˠ
ɜˤ	ɜˤ
ɜ̃	ɜ̃
ɜ̃ː	ɜ̃ː
ɜ̃ˤ	ɜ̃ˤ
ɜ̆	ɜ̆
ɜ̈	ɜ̈
ɜ̘	ɜ̘
ɜ̘ː	ɜ̘ː
ɜ̘ˠ	ɜ̘ˠ
ɜ̙	ɜ̙
ɜ̙ː	ɜ̙ː
ɜ̙ˠ	ɜ̙ˠ
ɜ̝	ɜ̝
ɜ̞	ɜ̞
ɜ̟	ɜ̟
ɜ̠	ɜ̠
ɜ̤	ɜ̤
ɜ̤ː	ɜ̤ː
ɜ̤ˠ	ɜ̤ˠ
ɜ̤ˤ	ɜ̤ˤ
ɜ̥̤	ɜ̤̥
ɜ̥	ɜ̥
ɜ̥ː	ɜ̥ː
ɜ̥ˠ	ɜ̥ˠ
ɜ̥ˤ	ɜ̥ˤ
ɜ̯	ɜ̯
ɜ̰	ɜ̰
ɜ̰ː	ɜ̰ː
ɜ̰ˠ	ɜ̰ˠ
ɜ̰ˤ	ɜ̰ˤ
ɜ̰̃	ɜ̰̃
ɞ	ɞ
ɞː	ɞː
ɞˠː	ɞːˠ
ɞˤː	ɞˤː
ɞ˞	ɞ˞
ɞˠ	ɞˠ
ɞˤ	ɞˤ
ɞ̃	ɞ̃
ɞ̃ː	ɞ̃ː
ɞ̃ˤ	ɞ̃ˤ
ɞ̆	ɞ̆
ɞ̈	ɞ̈
ɞ̘	ɞ̘
ɞ̘ː	ɞ̘ː
ɞ̘ˠ	ɞ̘ˠ
ɞ̙	ɞ̙
ɞ̙ː	ɞ̙ː
ɞ̙ˠ	ɞ̙ˠ
ɞ̝	ɞ̝
ɞ̞	ɞ̞
ɞ̟	ɞ̟
ɞ̠	ɞ̠
ɞ̤	ɞ̤
ɞ̤ː	ɞ̤ː
ɞ̤ˠ	ɞ̤ˠ
ɞ̤ˤ	ɞ̤ˤ
ɞ̥̤	ɞ̤̥
ɞ̥	ɞ̥
ɞ̥ː	ɞ̥ː
ɞ̥ˠ	ɞ̥ˠ
ɞ̥ˤ	ɞ̥ˤ
ɞ̯	ɞ̯
ɞ̰	ɞ̰
ɞ̰ː	ɞ̰ː
ɞ̰ˠ	ɞ̰ˠ
ɞ̰ˤ	ɞ̰ˤ
ɞ̰̃	ɞ̰̃
ɟ	ɟ
ɟʰ	ɟʰ
ɟʲʰ	ɟʲʰ
ɟʷʰ	ɟʷʰ
ɟʰː	ɟʰː
ɟˠʰ	ɟʰˠ
ɟˤʰ	ɟˤʰ
ɟᶣʰ	ɟʰᶣ
ɟʲ	ɟʲ
ɟʲʷ	ɟʲʷ
ɟʲʷʰ	ɟʲʷʰ
ɟʲː	ɟːʲ
ɟʷ	ɟʷ
ɟʷʰː	ɟʷʰː
ɟʷˀ	ɟʷˀ
ɟʷː	ɟːʷ
ɟʷˠ	ɟʷˠ
ɟʷˠʰ	ɟʷˠʰ
ɟʷˤ	ɟʷˤ
ɟʷˤʰ	ɟʷˤʰ
ɟˀ	ɟˀ
ɟː	ɟː
ɟˠː	ɟːˠ
ɟˤː	ɟˤː
ɟˠ	ɟˠ
ɟˤ	ɟˤ
ɟ̃	ɟ̃
ɟ̃ː	ɟ̃ː
ɟ̃ˤ	ɟ̃ˤ
ɟ̟	ɟ̟
ɟ̠	ɟ̠
ɟʱ	ɟ̤
ɟʲʱ	ɟ̤ʲ
ɟʷʱ	ɟ̤ʷ
ɟʱː	ɟ̤ː
ɟˠʱ	ɟ̤ˠ
ɟˤʱ	ɟ̤ˤ
ɟ̰	ɟ̰
ɟ̰ʲ	ɟ̰ʲ
ɟ̰ʷ	ɟ̰ʷ
ɟ̰ː	ɟ̰ː
ɟ̰ˠ	ɟ̰ˠ
ɟ̰ˤ	ɟ̰ˤ
ɟ̰̃	ɟ̰̃
ɟʝ	ɟ͡ʝ
ɟʝʰ	ɟ͡ʝʰ
ɟʝʲʰ	ɟ͡ʝʲʰ
ɟʝʷʰ	ɟ͡ʝʷʰ
ɟʝʰː	ɟ͡ʝʰː
ɟʝˠʰ	ɟ͡ʝʰˠ
ɟʝˤʰ	ɟ͡ʝˤʰ
ɟʝᶣʰ	ɟ͡ʝʰᶣ
ɟʝʲ	ɟ͡ʝʲ
ɟʝʲʷ	ɟ͡ʝʲʷ
ɟʝʲʷʰ	ɟ͡ʝʲʷʰ
ɟʝʲː	ɟ͡ʝːʲ
ɟʝʷ	ɟ͡ʝʷ
ɟʝʷʰː	ɟ͡ʝʷʰː
ɟʝʷˀ	ɟ͡ʝʷˀ
ɟʝʷː	ɟ͡ʝːʷ
ɟʝʷˠ	ɟ͡ʝʷˠ
ɟʝʷˠʰ	ɟ͡ʝʷˠʰ
ɟʝʷˤ	ɟ͡ʝʷˤ
ɟʝʷˤʰ	ɟ͡ʝʷˤʰ
ɟʝˀ	ɟ͡ʝˀ
ɟʝː	ɟ͡ʝː
ɟʝˠː	ɟ͡ʝːˠ
ɟʝˤː	ɟ͡ʝˤː
ɟʝˠ	ɟ͡ʝˠ
ɟʝˤ	ɟ͡ʝˤ
ɟʝ̃	ɟ͡ʝ̃
ɟʝ̃ː	ɟ͡ʝ̃ː
ɟʝ̃ˤ	ɟ͡ʝ̃ˤ
ɟʝ̟	ɟ͡ʝ̟
ɟʝ̠	ɟ͡ʝ̠
ɟʝʱ	ɟ͡ʝ̤
ɟʝʲʱ	ɟ͡ʝ̤ʲ
ɟʝʷʱ	ɟ͡ʝ̤ʷ
ɟʝʱː	ɟ͡ʝ̤ː
ɟʝˠʱ	ɟ͡ʝ̤ˠ
ɟʝˤʱ	ɟ͡ʝ̤ˤ
ɟʝ̰	ɟ͡ʝ̰
ɟʝ̰ʲ	ɟ͡ʝ̰ʲ
ɟʝ̰ʷ	ɟ͡ʝ̰ʷ
ɟʝ̰ː	ɟ͡ʝ̰ː
ɟʝ̰ˠ	ɟ͡ʝ̰ˠ
ɟʝ̰ˤ	ɟ͡ʝ̰ˤ
ɟʝ̰̃	ɟ͡ʝ̰̃
ɟʝ̺	ɟ͡ʝ̺
ɟʝ̻	ɟ͡ʝ̻
ɟʝᶣ	ɟ͡ʝᶣ
ɟᶣ	ɟᶣ
ɟⁿ	ɟⁿ
ɠ	ɠ
ɠʲ	ɠʲ
ɠʲʷ	ɠʲʷ
ɠʲː	ɠːʲ
ɠʷ	ɠʷ
ɠʷː	ɠːʷ
ɠʷˠ	ɠʷˠ
ɠʷˤ	ɠʷˤ
ɠː	ɠː
ɠˠː	ɠːˠ
ɠˤː	ɠˤː
ɠˠ	ɠˠ
ɠˤ	ɠˤ
ɠ̃	ɠ̃
ɠ̃ː	ɠ̃ː
ɠ̃ˤ	ɠ̃ˤ
ɠ̟	ɠ̟
ɠ̠	ɠ̠
ɠʱ	ɠ̤
ɠʲʱ	ɠ̤ʲ
ɠʷʱ	ɠ̤ʷ
ɠʱː	ɠ̤ː
ɠˠʱ	ɠ̤ˠ
ɠˤʱ	ɠ̤ˤ
ɠ̰	ɠ̰
ɠ̰ʲ	ɠ̰ʲ
ɠ̰ʷ	ɠ̰ʷ
ɠ̰ː	ɠ̰ː
ɠ̰ˠ	ɠ̰ˠ
ɠ̰ˤ	ɠ̰ˤ
ɠ̰̃	ɠ̰̃
ɠᶣ	ɠᶣ
ɠⁿ	ɠⁿ
g	ɡ
gʰ	ɡʰ
gʲʰ	ɡʲʰ
gʷʰ	ɡʷʰ
gʰː	ɡʰː
gɣʰ	ɡ͡ɣʰ
gˤʰ	ɡˤʰ
gᶣʰ	ɡʰᶣ
gʲ	ɡʲ
gʲʷ	ɡʲʷ
gʲʷʰ	ɡʲʷʰ
gʲː	ɡːʲ
gʷ	ɡʷ
gʷʰː	ɡʷʰː
gʷˀ	ɡʷˀ
gʷː	ɡːʷ
gʷˠ	ɡʷˠ
gʷˠʰ	ɡʷˠʰ
gʷˤ	ɡʷˤ
gʷˤʰ	ɡʷˤʰ
gˀ	ɡˀ
gː	ɡː
gɣː	ɡ͡ɣː
gˤː	ɡˤː
gˤ	ɡˤ
g̃	ɡ̃
g̃ː	ɡ̃ː
g̃ˤ	ɡ̃ˤ
g̟	ɡ̟
g̠	ɡ̠
gʱ	ɡ̤
gʲʱ	ɡ̤ʲ
gʷʱ	ɡ̤ʷ
gʱː	ɡ̤ː
gɣʱ	ɡ͡ɣ̤
gˤʱ	ɡ̤ˤ
g̰	ɡ̰
g̰ʲ	ɡ̰ʲ
g̰ʷ	ɡ̰ʷ
g̰ː	ɡ̰ː
g̰ˠ	ɡ̰ˠ
g̰ˤ	ɡ̰ˤ
g̰̃	ɡ̰̃
gb	ɡ͡b
gbʰ	ɡ͡bʰ
gbʲʰ	ɡ͡bʲʰ
gbʷʰ	ɡ͡bʷʰ
gbʰː	ɡ͡bʰː
gbˠʰ	ɡ͡bʰˠ
gbˤʰ	ɡ͡bˤʰ
gbʲ	ɡ͡bʲ
gbʲʷ	ɡ͡bʲʷ
gbʲʷʰ	ɡ͡bʲʷʰ
gbʲː	ɡ͡bːʲ
gbʷ	ɡ͡bʷ
gbʷʰː	ɡ͡bʷʰː
gbʷˀ	ɡ͡bʷˀ
gbʷː	ɡ͡bːʷ
gbʷˠ	ɡ͡bʷˠ
gbʷˠʰ	ɡ͡bʷˠʰ
gbʷˤ	ɡ͡bʷˤ
gbʷˤʰ	ɡ͡bʷˤʰ
gbˀ	ɡ͡bˀ
gbː	ɡ͡bː
gbˠː	ɡ͡bːˠ
gbˤː	ɡ͡bˤː
gbˠ	ɡ͡bˠ
gbˤ	ɡ͡bˤ
gb̃	ɡ͡b̃
gb̃ː	ɡ͡b̃ː
gb̃ˤ	ɡ͡b̃ˤ
gb̟	ɡ͡b̟
gb̠	ɡ͡b̠
gbʱ	ɡ͡b̤
gbʲʱ	ɡ͡b̤ʲ
gbʷʱ	ɡ͡b̤ʷ
gbʱː	ɡ͡b̤ː
gbˠʱ	ɡ͡b̤ˠ
gbˤʱ	ɡ͡b̤ˤ
gb̰	ɡ͡b̰
gb̰ʲ	ɡ͡b̰ʲ
gb̰ʷ	ɡ͡b̰ʷ
gb̰ː	ɡ͡b̰ː
gb̰ˠ	ɡ͡b̰ˠ
gb̰ˤ	ɡ͡b̰ˤ
gb̰̃	ɡ͡b̰̃
gbⁿ	ɡ͡bⁿ
gɣ	ɡ͡ɣ
gɣʲʰ	ɡ͡ɣʲʰ
gɣʷʰ	ɡ͡ɣʷʰ
gɣʰː	ɡ͡ɣʰː
gɣˠʰ	ɡ͡ɣʰˠ
gɣˤʰ	ɡ͡ɣˤʰ
gɣᶣʰ	ɡ͡ɣʰᶣ
gɣʲ	ɡ͡ɣʲ
gɣʲʷ	ɡ͡ɣʲʷ
gɣʲʷʰ	ɡ͡ɣʲʷʰ
gɣʲː	ɡ͡ɣːʲ
gɣʷ	ɡ͡ɣʷ
gɣʷʰː	ɡ͡ɣʷʰː
gɣʷˀ	ɡ͡ɣʷˀ
gɣʷː	ɡ͡ɣːʷ
gɣʷˠ	ɡ͡ɣʷˠ
gɣʷˠʰ	ɡ͡ɣʷˠʰ
gɣʷˤ	ɡ͡ɣʷˤ
gɣʷˤʰ	ɡ͡ɣʷˤʰ
gɣˀ	ɡ͡ɣˀ
gɣˠː	ɡ͡ɣːˠ
gɣˤː	ɡ͡ɣˤː
gɣˠ	ɡ͡ɣˠ
gɣˤ	ɡ͡ɣˤ
gɣ̃	ɡ͡ɣ̃
gɣ̃ː	ɡ͡ɣ̃ː
gɣ̃ˤ	ɡ͡ɣ̃ˤ
gɣ̟	ɡ͡ɣ̟
gɣ̠	ɡ͡ɣ̠
gɣʲʱ	ɡ͡ɣ̤ʲ
gɣʷʱ	ɡ͡ɣ̤ʷ
gɣʱː	ɡ͡ɣ̤ː
gɣˠʱ	ɡ͡ɣ̤ˠ
gɣˤʱ	ɡ͡ɣ̤ˤ
gɣ̰	ɡ͡ɣ̰
gɣ̰ʲ	ɡ͡ɣ̰ʲ
gɣ̰ʷ	ɡ͡ɣ̰ʷ
gɣ̰ː	ɡ͡ɣ̰ː
gɣ̰ˠ	ɡ͡ɣ̰ˠ
gɣ̰ˤ	ɡ͡ɣ̰ˤ
gɣ̰̃	ɡ͡ɣ̰̃
gɣᶣ	ɡ͡ɣᶣ
gᶣ	ɡᶣ
gⁿ	ɡⁿ
ɢ	ɢ
ɢʰ	ɢʰ
ɢʲʰ	ɢʲʰ
ɢʷʰ	ɢʷʰ
ɢʰː	ɢʰː
ɢˠʰ	ɢʰˠ
ɢˤʰ	ɢˤʰ
ɢᶣʰ	ɢʰᶣ
ɢʲ	ɢʲ
ɢʲʷ	ɢʲʷ
ɢʲʷʰ	ɢʲʷʰ
ɢʲː	ɢːʲ
ɢʷ	ɢʷ
ɢʷʰː	ɢʷʰː
ɢʷˀ	ɢʷˀ
ɢʷː	ɢːʷ
ɢʷˠ	ɢʷˠ
ɢʷˠʰ	ɢʷˠʰ
ɢʷˤ	ɢʷˤ
ɢʷˤʰ	ɢʷˤʰ
ɢˀ	ɢˀ
ɢː	ɢː
ɢˠː	ɢːˠ
ɢˤː	ɢˤː
ɢˠ	ɢˠ
ɢˤ	ɢˤ
ɢ̃	ɢ̃
ɢ̃ː	ɢ̃ː
ɢ̃ˤ	ɢ̃ˤ
ɢ̟	ɢ̟
ɢ̠	ɢ̠
ɢʱ	ɢ̤
ɢʲʱ	ɢ̤ʲ
ɢʷʱ	ɢ̤ʷ
ɢʱː	ɢ̤ː
ɢˠʱ	ɢ̤ˠ
ɢˤʱ	ɢ̤ˤ
ɢ̰	ɢ̰
ɢ̰ʲ	ɢ̰ʲ
ɢ̰ʷ	ɢ̰ʷ
ɢ̰ː	ɢ̰ː
ɢ̰ˠ	ɢ̰ˠ
ɢ̰ˤ	ɢ̰ˤ
ɢ̰̃	ɢ̰̃
ɢʁ	ɢ͡ʁ
ɢʁʰ	ɢ͡ʁʰ
ɢʁʲʰ	ɢ͡ʁʲʰ
ɢʁʷʰ	ɢ͡ʁʷʰ
ɢʁʰː	ɢ͡ʁʰː
ɢʁˠʰ	ɢ͡ʁʰˠ
ɢʁˤʰ	ɢ͡ʁˤʰ
ɢʁᶣʰ	ɢ͡ʁʰᶣ
ɢʁʲ	ɢ͡ʁʲ
ɢʁʲʷ	ɢ͡ʁʲʷ
ɢʁʲʷʰ	ɢ͡ʁʲʷʰ
ɢʁʲː	ɢ͡ʁːʲ
ɢʁʷ	ɢ͡ʁʷ
ɢʁʷʰː	ɢ͡ʁʷʰː
ɢʁʷˀ	ɢ͡ʁʷˀ
ɢʁʷː	ɢ͡ʁːʷ
ɢʁʷˠ	ɢ͡ʁʷˠ
ɢʁʷˠʰ	ɢ͡ʁʷˠʰ
ɢʁʷˤ	ɢ͡ʁʷˤ
ɢʁʷˤʰ	ɢ͡ʁʷˤʰ
ɢʁˀ	ɢ͡ʁˀ
ɢʁː	ɢ͡ʁː
ɢʁˠː	ɢ͡ʁːˠ
ɢʁˤː	ɢ͡ʁˤː
ɢʁˠ	ɢ͡ʁˠ
ɢʁˤ	ɢ͡ʁˤ
ɢʁ̃	ɢ͡ʁ̃
ɢʁ̃ː	ɢ͡ʁ̃ː
ɢʁ̃ˤ	ɢ͡ʁ̃ˤ
ɢʁ̟	ɢ͡ʁ̟
ɢʁ̠	ɢ͡ʁ̠
ɢʁʱ	ɢ͡ʁ̤
ɢʁʲʱ	ɢ͡ʁ̤ʲ
ɢʁʷʱ	ɢ͡ʁ̤ʷ
ɢʁʱː	ɢ͡ʁ̤ː
ɢʁˠʱ	ɢ͡ʁ̤ˠ
ɢʁˤʱ	ɢ͡ʁ̤ˤ
ɢʁ̰	ɢ͡ʁ̰
ɢʁ̰ʲ	ɢ͡ʁ̰ʲ
ɢʁ̰ʷ	ɢ͡ʁ̰ʷ
ɢʁ̰ː	ɢ͡ʁ̰ː
ɢʁ̰ˠ	ɢ͡ʁ̰ˠ
ɢʁ̰ˤ	ɢ͡ʁ̰ˤ
ɢʁ̰̃	ɢ͡ʁ̰̃
ɢʁᶣ	ɢ͡ʁᶣ
ɢᶣ	ɢᶣ
ɢⁿ	ɢⁿ
ɣ	ɣ
ɣʲ	ɣʲ
ɣʲʷ	ɣʲʷ
ɣʲː	ɣːʲ
ɣʷ	ɣʷ
ɣʷˀ	ɣʷˀ
ɣʷː	ɣːʷ
ɣʷˠ	ɣʷˠ
ɣʷˤ	ɣʷˤ
ɣˀ	ɣˀ
ɣː	ɣː
ɣˠː	ɣːˠ
ɣˤː	ɣˤː
ɣˤ	ɣˤ
ɣ̃	ɣ̃
ɣ̃ː	ɣ̃ː
ɣ̃ˤ	ɣ̃ˤ
ɣ̝	ɣ̝
ɣ̞	ɣ̞
ɣ̟	ɣ̟
ɣ̠	ɣ̠
ɣʱ	ɣ̤
ɣʲʱ	ɣ̤ʲ
ɣʷʱ	ɣ̤ʷ
ɣʱː	ɣ̤ː
ɣˠʱ	ɣ̤ˠ
ɣˤʱ	ɣ̤ˤ
ɣ̩	ɣ̩
ɣ̰	ɣ̰
ɣ̰ʲ	ɣ̰ʲ
ɣ̰ʷ	ɣ̰ʷ
ɣ̰ː	ɣ̰ː
ɣ̰ˠ	ɣ̰ˠ
ɣ̰ˤ	ɣ̰ˤ
ɣ̰̃	ɣ̰̃
ɣᶣ	ɣᶣ
ɤ	ɤ
ɤː	ɤː
ɤˠː	ɤːˠ
ɤˤː	ɤˤː
ɤ˞	ɤ˞
ɤˠ	ɤˠ
ɤˤ	ɤˤ
ɤ̃	ɤ̃
ɤ̃ː	ɤ̃ː
ɤ̃ˤ	ɤ̃ˤ
ɤ̆	ɤ̆
ɤ̈	ɤ̈
ɤ̘	ɤ̘
ɤ̘ː	ɤ̘ː
ɤ̘ˠ	ɤ̘ˠ
ɤ̙	ɤ̙
ɤ̙ː	ɤ̙ː
ɤ̙ˠ	ɤ̙ˠ
ɤ̝	ɤ̝
ɤ̞	ɤ̞
ɤ̟	ɤ̟
ɤ̠	ɤ̠
ɤ̤	ɤ̤
ɤ̤ː	ɤ̤ː
ɤ̤ˠ	ɤ̤ˠ
ɤ̤ˤ	ɤ̤ˤ
ɤ̥̤	ɤ̤̥
ɤ̥	ɤ̥
ɤ̥ː	ɤ̥ː
ɤ̥ˠ	ɤ̥ˠ
ɤ̥ˤ	ɤ̥ˤ
ɤ̯	ɤ̯
ɤ̰	ɤ̰
ɤ̰ː	ɤ̰ː
ɤ̰ˠ	ɤ̰ˠ
ɤ̰ˤ	ɤ̰ˤ
ɤ̰̃	ɤ̰̃
ɥ	ɥ
ɥˀ	ɥˀ
ɥː	ɥː
ɥʲː	ɥːʲ
ɥʷː	ɥːʷ
ɥˠː	ɥːˠ
ɥˤː	ɥˤː
ɥˠ	ɥˠ
ɥˤ	ɥˤ
ɥ̃	ɥ̃
ɥ̃ː	ɥ̃ː
ɥ̃ˤ	ɥ̃ˤ
ɥ̝	ɥ̝
ɥ̞	ɥ̞
ɥ̟	ɥ̟
ɥ̠	ɥ̠
ɥʱ	ɥ̤
ɥʲʱ	ɥ̤ʲ
ɥʷʱ	ɥ̤ʷ
ɥʱː	ɥ̤ː
ɥˠʱ	ɥ̤ˠ
ɥˤʱ	ɥ̤ˤ
ɥ̥ʱ	ɥ̤̥
ɥ̥	ɥ̥
ɥ̥ʲ	ɥ̥ʲ
ɥ̥ʷ	ɥ̥ʷ
ɥ̥ː	ɥ̥ː
ɥ̥ˠ	ɥ̥ˠ
ɥ̥ˤ	ɥ̥ˤ
ɥ̩	ɥ̩
ɥ̰	ɥ̰
ɥ̰ʲ	ɥ̰ʲ
ɥ̰ʷ	ɥ̰ʷ
ɥ̰ː	ɥ̰ː
ɥ̰ˠ	ɥ̰ˠ
ɥ̰ˤ	ɥ̰ˤ
ɥ̰̃	ɥ̰̃
ɦ	ɦ
ɦʲ	ɦʲ
ɦʲʷ	ɦʲʷ
ɦʲː	ɦːʲ
ɦʷ	ɦʷ
ɦʷˀ	ɦʷˀ
ɦʷː	ɦːʷ
ɦʷˠ	ɦʷˠ
ɦʷˤ	ɦʷˤ
ɦˀ	ɦˀ
ɦː	ɦː
ɦˠː	ɦːˠ
ɦˤː	ɦˤː
ɦˠ	ɦˠ
ɦˤ	ɦˤ
ɦ̝	ɦ̝
ɦ̞	ɦ̞
ɦ̟	ɦ̟
ɦ̠	ɦ̠
ɦ̩	ɦ̩
ɦᶣ	ɦᶣ
ɧ	ɧ
ɧʰ	ɧʰ
ɧʲʰ	ɧʲʰ
ɧʷʰ	ɧʷʰ
ɧʰː	ɧʰː
ɧˠʰ	ɧʰˠ
ɧˤʰ	ɧˤʰ
ɧᶣʰ	ɧʰᶣ
ɧʲ	ɧʲ
ɧʲʷ	ɧʲʷ
ɧʲʷʰ	ɧʲʷʰ
ɧʼʲ	ɧʼʲ
ɧʲː	ɧːʲ
ɧʷ	ɧʷ
ɧʷʰː	ɧʷʰː
ɧʼʷ	ɧʼʷ
ɧʷˀ	ɧʷˀ
ɧʷː	ɧːʷ
ɧʷˠ	ɧʷˠ
ɧʷˠʰ	ɧʷˠʰ
ɧʷˤ	ɧʷˤ
ɧʷˤʰ	ɧʷˤʰ
ɧʼʷˤ	ɧʷˤʼ
ɧʼ	ɧʼ
ɧʼː	ɧʼː
ɧˀ	ɧˀ
ɧː	ɧː
ɧˠː	ɧːˠ
ɧˤː	ɧˤː
ɧˠ	ɧˠ
ɧˤ	ɧˤ
ɧʼˤ	ɧˤʼ
ɧ̝	ɧ̝
ɧ̞	ɧ̞
ɧ̟	ɧ̟
ɧ̠	ɧ̠
ɧ̺	ɧ̺
ɧ̻	ɧ̻
ɧᶣ	ɧᶣ
ɨ	ɨ
ɨː	ɨː
ɨˤː	ɨˤː
ɨ˞	ɨ˞
ɨˤ	ɨˤ
ɨ̃	ɨ̃
ɨ̃ː	ɨ̃ː
ɨ̃ˤ	ɨ̃ˤ
ɨ̆	ɨ̆
ɨ̈	ɨ̈
ɨ̘	ɨ̘
ɨ̘ː	ɨ̘ː
ɨ̙	ɨ̙
ɨ̙ː	ɨ̙ː
ɨ̝	ɨ̝
ɨ̞	ɨ̞
ɨ̟	ɨ̟
ɨ̠	ɨ̠
ɨ̤	ɨ̤
ɨ̤ː	ɨ̤ː
ɨ̤ˤ	ɨ̤ˤ
ɨ̥̤	ɨ̤̥
ɨ̥	ɨ̥
ɨ̥ː	ɨ̥ː
ɨ̥ˤ	ɨ̥ˤ
ɨ̯	ɨ̯
ɨ̰	ɨ̰
ɨ̰ː	ɨ̰ː
ɨ̰ˤ	ɨ̰ˤ
ɨ̰̃	ɨ̰̃
ɪ	ɪ
ɪː	ɪː
ɪˠː	ɪːˠ
ɪˤː	ɪˤː
ɪ˞	ɪ˞
ɪˠ	ɪˠ
ɪˤ	ɪˤ
ɪ̃	ɪ̃
ɪ̃ː	ɪ̃ː
ɪ̃ˤ	ɪ̃ˤ
ɪ̆	ɪ̆
ɪ̈	ɪ̈
ɪ̘	ɪ̘
ɪ̘ː	ɪ̘ː
ɪ̘ˠ	ɪ̘ˠ
ɪ̙	ɪ̙
ɪ̙ː	ɪ̙ː
ɪ̙ˠ	ɪ̙ˠ
ɪ̝	ɪ̝
ɪ̞	ɪ̞
ɪ̟	ɪ̟
ɪ̠	ɪ̠
ɪ̤	ɪ̤
ɪ̤ː	ɪ̤ː
ɪ̤ˠ	ɪ̤ˠ
ɪ̤ˤ	ɪ̤ˤ
ɪ̥̤	ɪ̤̥
ɪ̥	ɪ̥
ɪ̥ː	ɪ̥ː
ɪ̥ˠ	ɪ̥ˠ
ɪ̥ˤ	ɪ̥ˤ
ɪ̯	ɪ̯
ɪ̰	ɪ̰
ɪ̰ː	ɪ̰ː
ɪ̰ˠ	ɪ̰ˠ
ɪ̰ˤ	ɪ̰ˤ
ɪ̰̃	ɪ̰̃
lʲˠ	ɫʲ
lʲʷˠ	ɫʲʷ
lʲˠː	ɫːʲ
lʷˠˀ	ɫʷˀ
lʷˠː	ɫːʷ
lʷˠˤ	ɫʷˤ
lˠˀ	ɫˀ
lˠˤː	ɫˤː
lˠˤ	ɫˤ
l̃ˠ	ɫ̃
l̃ˠː	ɫ̃ː
l̃ˠˤ	ɫ̃ˤ
l̝ˠ	ɫ̝
l̞ˠ	ɫ̞
l̟ˠ	ɫ̟
l̠ˠ	ɫ̠
lʲˠʱ	ɫ̤ʲ
lʷˠʱ	ɫ̤ʷ
lˠʱː	ɫ̤ː
lˠˤʱ	ɫ̤ˤ
l̥ˠʱ	ɫ̤̥
l̥ʲˠ	ɫ̥ʲ
l̥ʷˠ	ɫ̥ʷ
l̥ˠː	ɫ̥ː
l̥ˠˤ	ɫ̥ˤ
l̩ˠ	ɫ̩
l̰ʲˠ	ɫ̰ʲ
l̰ʷˠ	ɫ̰ʷ
l̰ˠː	ɫ̰ː
l̰ˠˤ	ɫ̰ˤ
l̰̃ˠ	ɫ̰̃
l̺ˠ	ɫ̺
l̻ˠ	ɫ̻
lᶣˠ	ɫᶣ
ɬ	ɬ
ɬʰ	ɬʰ
ɬʲʰ	ɬʲʰ
ɬʷʰ	ɬʷʰ
ɬʰː	ɬʰː
ɬˠʰ	ɬʰˠ
ɬˤʰ	ɬˤʰ
ɬᶣʰ	ɬʰᶣ
ɬʲ	ɬʲ
ɬʲʷ	ɬʲʷ
ɬʲʷʰ	ɬʲʷʰ
ɬʼʲ	ɬʼʲ
ɬʲː	ɬːʲ
ɬʷ	ɬʷ
ɬʷʰː	ɬʷʰː
ɬʼʷ	ɬʼʷ
ɬʷˀ	ɬʷˀ
ɬʷː	ɬːʷ
ɬʷˠ	ɬʷˠ
ɬʷˠʰ	ɬʷˠʰ
ɬʷˤ	ɬʷˤ
ɬʷˤʰ	ɬʷˤʰ
ɬʼʷˤ	ɬʷˤʼ
ɬʼ	ɬʼ
ɬʼː	ɬʼː
ɬˀ	ɬˀ
ɬː	ɬː
ɬˠː	ɬːˠ
ɬˤː	ɬˤː
ɬˠ	ɬˠ
ɬˤ	ɬˤ
ɬʼˤ	ɬˤʼ
ɬ̝	ɬ̝
ɬ̞	ɬ̞
ɬ̟	ɬ̟
ɬ̠	ɬ̠
ɬ̪	ɬ̪
ɬ̪ʰ	ɬ̪ʰ
ɬ̪ʲʰ	ɬ̪ʲʰ
ɬ̪ʷʰ	ɬ̪ʷʰ
ɬ̪ʰː	ɬ̪ʰː
ɬ̪ˠʰ	ɬ̪ʰˠ
ɬ̪ˤʰ	ɬ̪ˤʰ
ɬ̪ᶣʰ	ɬ̪ʰᶣ
ɬ̪ʲ	ɬ̪ʲ
ɬ̪ʲʷ	ɬ̪ʲʷ
ɬ̪ʲʷʰ	ɬ̪ʲʷʰ
ɬ̪ʼʲ	ɬ̪ʼʲ
ɬ̪ʲː	ɬ̪ːʲ
ɬ̪ʷ	ɬ̪ʷ
ɬ̪ʷʰː	ɬ̪ʷʰː
ɬ̪ʼʷ	ɬ̪ʼʷ
ɬ̪ʷˀ	ɬ̪ʷˀ
ɬ̪ʷː	ɬ̪ːʷ
ɬ̪ʷˠ	ɬ̪ʷˠ
ɬ̪ʷˠʰ	ɬ̪ʷˠʰ
ɬ̪ʷˤ	ɬ̪ʷˤ
ɬ̪ʷˤʰ	ɬ̪ʷˤʰ
ɬ̪ʼʷˤ	ɬ̪ʷˤʼ
ɬ̪ʼ	ɬ̪ʼ
ɬ̪ʼː	ɬ̪ʼː
ɬ̪ˀ	ɬ̪ˀ
ɬ̪ː	ɬ̪ː
ɬ̪ˠː	ɬ̪ːˠ
ɬ̪ˤː	ɬ̪ˤː
ɬ̪ˠ	ɬ̪ˠ
ɬ̪ˤ	ɬ̪ˤ
ɬ̪ʼˤ	ɬ̪ˤʼ
ɬ̪̝	ɬ̪̝
ɬ̪̞	ɬ̪̞
ɬ̪̟	ɬ̪̟
ɬ̪̠	ɬ̪̠
ɬ̪̺	ɬ̪̺
ɬ̪̻	ɬ̪̻
ɬ̪ᶣ	ɬ̪ᶣ
ɬ̺	ɬ̺
ɬ̻	ɬ̻
ɬᶣ	ɬᶣ
ɭ	ɭ
ɭʲ	ɭʲ
ɭʲʷ	ɭʲʷ
ɭʲː	ɭːʲ
ɭʷ	ɭʷ
ɭʷˀ	ɭʷˀ
ɭʷː	ɭːʷ
ɭʷˠ	ɭʷˠ
ɭʷˤ	ɭʷˤ
ɭˀ	ɭˀ
ɭː	ɭː
ɭˠː	ɭːˠ
ɭˤː	ɭˤː
ɭˠ	ɭˠ
ɭˤ	ɭˤ
ɭ̃	ɭ̃
ɭ̃ː	ɭ̃ː
ɭ̃ˤ	ɭ̃ˤ
ɭ̝	ɭ̝
ɭ̞	ɭ̞
ɭ̟	ɭ̟
ɭ̠	ɭ̠
ɭʱ	ɭ̤
ɭʲʱ	ɭ̤ʲ
ɭʷʱ	ɭ̤ʷ
ɭʱː	ɭ̤ː
ɭˠʱ	ɭ̤ˠ
ɭˤʱ	ɭ̤ˤ
ɭ̥ʱ	ɭ̤̥
ɭ̊	ɭ̥
ɭ̥ʲ	ɭ̥ʲ
ɭ̥ʷ	ɭ̥ʷ
ɭ̥ː	ɭ̥ː
ɭ̥ˠ	ɭ̥ˠ
ɭ̥ˤ	ɭ̥ˤ
ɭ̩	ɭ̩
ɭ̰	ɭ̰
ɭ̰ʲ	ɭ̰ʲ
ɭ̰ʷ	ɭ̰ʷ
ɭ̰ː	ɭ̰ː
ɭ̰ˠ	ɭ̰ˠ
ɭ̰ˤ	ɭ̰ˤ
ɭ̰̃	ɭ̰̃
ɭ̺	ɭ̺
ɭ̻	ɭ̻
ɭᶣ	ɭᶣ
ɮ	ɮ
ɮʲ	ɮʲ
ɮʲʷ	ɮʲʷ
ɮʲː	ɮːʲ
ɮʷ	ɮʷ
ɮʷˀ	ɮʷˀ
ɮʷː	ɮːʷ
ɮʷˠ	ɮʷˠ
ɮʷˤ	ɮʷˤ
ɮˀ	ɮˀ
ɮː	ɮː
ɮˠː	ɮːˠ
ɮˤː	ɮˤː
ɮˠ	ɮˠ
ɮˤ	ɮˤ
ɮ̃	ɮ̃
ɮ̃ː	ɮ̃ː
ɮ̃ˤ	ɮ̃ˤ
ɮ̝	ɮ̝
ɮ̞	ɮ̞
ɮ̟	ɮ̟
ɮ̠	ɮ̠
ɮʱ	ɮ̤
ɮʲʱ	ɮ̤ʲ
ɮʷʱ	ɮ̤ʷ
ɮʱː	ɮ̤ː
ɮˠʱ	ɮ̤ˠ
ɮˤʱ	ɮ̤ˤ
ɮ̰	ɮ̰
ɮ̰ʲ	ɮ̰ʲ
ɮ̰ʷ	ɮ̰ʷ
ɮ̰ː	ɮ̰ː
ɮ̰ˠ	ɮ̰ˠ
ɮ̰ˤ	ɮ̰ˤ
ɮ̰̃	ɮ̰̃
ɮ̺	ɮ̺
ɮ̻	ɮ̻
ɮᶣ	ɮᶣ
ɯ	ɯ
ɯː	ɯː
ɯˤː	ɯˤː
ɯ˞	ɯ˞
ɯˤ	ɯˤ
ɯ̃	ɯ̃
ɯ̃ː	ɯ̃ː
ɯ̃ˤ	ɯ̃ˤ
ɯ̆	ɯ̆
ɯ̈	ɯ̈
ɯ̘	ɯ̘
ɯ̘ː	ɯ̘ː
ɯ̙	ɯ̙
ɯ̙ː	ɯ̙ː
ɯ̝	ɯ̝
ɯ̞	ɯ̞
ɯ̟	ɯ̟
ɯ̠	ɯ̠
ɯ̤	ɯ̤
ɯ̤ː	ɯ̤ː
ɯ̤ˤ	ɯ̤ˤ
ɯ̥̤	ɯ̤̥
ɯ̥	ɯ̥
ɯ̥ː	ɯ̥ː
ɯ̥ˤ	ɯ̥ˤ
ɯ̯	ɯ̯
ɯ̰	ɯ̰
ɯ̰ː	ɯ̰ː
ɯ̰ˤ	ɯ̰ˤ
ɯ̰̃	ɯ̰̃
ɰ	ɰ
ɰʲ	ɰʲ
ɰʲʷ	ɰʲʷ
ɰʲː	ɰːʲ
ɰʷ	ɰʷ
ɰʷˀ	ɰʷˀ
ɰʷː	ɰːʷ
ɰʷˠ	ɰʷˠ
ɰʷˤ	ɰʷˤ
ɰˀ	ɰˀ
ɰː	ɰː
ɰˠː	ɰːˠ
ɰˤː	ɰˤː
ɰˤ	ɰˤ
ɰ̃	ɰ̃
ɰ̃ː	ɰ̃ː
ɰ̃ˤ	ɰ̃ˤ
ɰ̝	ɰ̝
ɰ̞	ɰ̞
ɰ̟	ɰ̟
ɰ̠	ɰ̠
ɰʱ	ɰ̤
ɰʲʱ	ɰ̤ʲ
ɰʷʱ	ɰ̤ʷ
ɰʱː	ɰ̤ː
ɰˠʱ	ɰ̤ˠ
ɰˤʱ	ɰ̤ˤ
ɰ̥ʱ	ɰ̤̥
ɰ̥	ɰ̥
ɰ̥ʲ	ɰ̥ʲ
ɰ̥ʷ	ɰ̥ʷ
ɰ̥ː	ɰ̥ː
ɰ̥ˠ	ɰ̥ˠ
ɰ̥ˤ	ɰ̥ˤ
ɰ̩	ɰ̩
ɰ̰	ɰ̰
ɰ̰ʲ	ɰ̰ʲ
ɰ̰ʷ	ɰ̰ʷ
ɰ̰ː	ɰ̰ː
ɰ̰ˠ	ɰ̰ˠ
ɰ̰ˤ	ɰ̰ˤ
ɰ̰̃	ɰ̰̃
ɰᶣ	ɰᶣ
ɱ	ɱ
ɱʲ	ɱʲ
ɱʲʷ	ɱʲʷ
ɱʲː	ɱːʲ
ɱʷ	ɱʷ
ɱʷˀ	ɱʷˀ
ɱʷː	ɱːʷ
ɱʷˠ	ɱʷˠ
ɱʷˤ	ɱʷˤ
ɱˀ	ɱˀ
ɱː	ɱː
ɱˠː	ɱːˠ
ɱˤː	ɱˤː
ɱˠ	ɱˠ
ɱˤ	ɱˤ
ɱ̟	ɱ̟
ɱ̠	ɱ̠
ɱʱ	ɱ̤
ɱʲʱ	ɱ̤ʲ
ɱʷʱ	ɱ̤ʷ
ɱʱː	ɱ̤ː
ɱˠʱ	ɱ̤ˠ
ɱˤʱ	ɱ̤ˤ
ɱ̥ʱ	ɱ̤̥
ɱ̊	ɱ̥
ɱ̥ʲ	ɱ̥ʲ
ɱ̥ʷ	ɱ̥ʷ
ɱ̥ː	ɱ̥ː
ɱ̥ˠ	ɱ̥ˠ
ɱ̥ˤ	ɱ̥ˤ
ɱ̩	ɱ̩
ɱ̰	ɱ̰
ɱ̰ʲ	ɱ̰ʲ
ɱ̰ʷ	ɱ̰ʷ
ɱ̰ː	ɱ̰ː
ɱ̰ˠ	ɱ̰ˠ
ɱ̰ˤ	ɱ̰ˤ
ɲ	ɲ
ɲʲ	ɲʲ
ɲʲʷ	ɲʲʷ
ɲʲː	ɲːʲ
ɲʷ	ɲʷ
ɲʷˀ	ɲʷˀ
ɲʷː	ɲːʷ
ɲʷˠ	ɲʷˠ
ɲʷˤ	ɲʷˤ
ɲˀ	ɲˀ
ɲː	ɲː
ɲˠː	ɲːˠ
ɲˤː	ɲˤː
ɲˠ	ɲˠ
ɲˤ	ɲˤ
ɲ̟	ɲ̟
ɲ̠	ɲ̠
ɲʱ	ɲ̤
ɲʲʱ	ɲ̤ʲ
ɲʷʱ	ɲ̤ʷ
ɲʱː	ɲ̤ː
ɲˠʱ	ɲ̤ˠ
ɲˤʱ	ɲ̤ˤ
ɲ̥ʱ	ɲ̤̥
ɲ̊	ɲ̥
ɲ̥ʲ	ɲ̥ʲ
ɲ̥ʷ	ɲ̥ʷ
ɲ̥ː	ɲ̥ː
ɲ̥ˠ	ɲ̥ˠ
ɲ̥ˤ	ɲ̥ˤ
ɲ̍	ɲ̩
ɲ̰	ɲ̰
ɲ̰ʲ	ɲ̰ʲ
ɲ̰ʷ	ɲ̰ʷ
ɲ̰ː	ɲ̰ː
ɲ̰ˠ	ɲ̰ˠ
ɲ̰ˤ	ɲ̰ˤ
ɲᶣ	ɲᶣ
ɳ	ɳ
ɳʲ	ɳʲ
ɳʲʷ	ɳʲʷ
ɳʲː	ɳːʲ
ɳʷ	ɳʷ
ɳʷˀ	ɳʷˀ
ɳʷː	ɳːʷ
ɳʷˠ	ɳʷˠ
ɳʷˤ	ɳʷˤ
ɳˀ	ɳˀ
ɳː	ɳː
ɳˠː	ɳːˠ
ɳˤː	ɳˤː
ɳˠ	ɳˠ
ɳˤ	ɳˤ
ɳ̟	ɳ̟
ɳ̠	ɳ̠
ɳʱ	ɳ̤
ɳʲʱ	ɳ̤ʲ
ɳʷʱ	ɳ̤ʷ
ɳʱː	ɳ̤ː
ɳˠʱ	ɳ̤ˠ
ɳˤʱ	ɳ̤ˤ
ɳ̥ʱ	ɳ̤̥
ɳ̊	ɳ̥
ɳ̥ʲ	ɳ̥ʲ
ɳ̥ʷ	ɳ̥ʷ
ɳ̥ː	ɳ̥ː
ɳ̥ˠ	ɳ̥ˠ
ɳ̥ˤ	ɳ̥ˤ
ɳ̍	ɳ̩
ɳ̰	ɳ̰
ɳ̰ʲ	ɳ̰ʲ
ɳ̰ʷ	ɳ̰ʷ
ɳ̰ː	ɳ̰ː
ɳ̰ˠ	ɳ̰ˠ
ɳ̰ˤ	ɳ̰ˤ
ɳ̺	ɳ̺
ɳ̻	ɳ̻
ɳᶣ	ɳᶣ
ɴ	ɴ
ɴʲ	ɴʲ
ɴʲʷ	ɴʲʷ
ɴʲː	ɴːʲ
ɴʷ	ɴʷ
ɴʷˀ	ɴʷˀ
ɴʷː	ɴːʷ
ɴʷˠ	ɴʷˠ
ɴʷˤ	ɴʷˤ
ɴˀ	ɴˀ
ɴː	ɴː
ɴˠː	ɴːˠ
ɴˤː	ɴˤː
ɴˠ	ɴˠ
ɴˤ	ɴˤ
ɴ̟	ɴ̟
ɴ̠	ɴ̠
ɴʱ	ɴ̤
ɴʲʱ	ɴ̤ʲ
ɴʷʱ	ɴ̤ʷ
ɴʱː	ɴ̤ː
ɴˠʱ	ɴ̤ˠ
ɴˤʱ	ɴ̤ˤ
ɴ̥ʱ	ɴ̤̥
ɴ̥	ɴ̥
ɴ̥ʲ	ɴ̥ʲ
ɴ̥ʷ	ɴ̥ʷ
ɴ̥ː	ɴ̥ː
ɴ̥ˠ	ɴ̥ˠ
ɴ̥ˤ	ɴ̥ˤ
ɴ̩	ɴ̩
ɴ̰	ɴ̰
ɴ̰ʲ	ɴ̰ʲ
ɴ̰ʷ	ɴ̰ʷ
ɴ̰ː	ɴ̰ː
ɴ̰ˠ	ɴ̰ˠ
ɴ̰ˤ	ɴ̰ˤ
ɴᶣ	ɴᶣ
ɵ	ɵ
ɵː	ɵː
ɵˠː	ɵːˠ
ɵˤː	ɵˤː
ɵ˞	ɵ˞
ɵˠ	ɵˠ
ɵˤ	ɵˤ
ɵ̃	ɵ̃
ɵ̃ː	ɵ̃ː
ɵ̃ˤ	ɵ̃ˤ
ɵ̆	ɵ̆
ɵ̈	ɵ̈
ɵ̘	ɵ̘
ɵ̘ː	ɵ̘ː
ɵ̘ˠ	ɵ̘ˠ
ɵ̙	ɵ̙
ɵ̙ː	ɵ̙ː
ɵ̙ˠ	ɵ̙ˠ
ɵ̝	ɵ̝
ɵ̞	ɵ̞
ɵ̟	ɵ̟
ɵ̠	ɵ̠
ɵ̤	ɵ̤
ɵ̤ː	ɵ̤ː
ɵ̤ˠ	ɵ̤ˠ
ɵ̤ˤ	ɵ̤ˤ
ɵ̥̤	ɵ̤̥
ɵ̥	ɵ̥
ɵ̥ː	ɵ̥ː
ɵ̥ˠ	ɵ̥ˠ
ɵ̥ˤ	ɵ̥ˤ
ɵ̯	ɵ̯
ɵ̰	ɵ̰
ɵ̰ː	ɵ̰ː
ɵ̰ˠ	ɵ̰ˠ
ɵ̰ˤ	ɵ̰ˤ
ɵ̰̃	ɵ̰̃
ɶ	ɶ
ɶː	ɶː
ɶˠː	ɶːˠ
ɶˤː	ɶˤː
ɶ˞	ɶ˞
ɶˠ	ɶˠ
ɶˤ	ɶˤ
ɶ̃	ɶ̃
ɶ̃ː	ɶ̃ː
ɶ̃ˤ	ɶ̃ˤ
ɶ̆	ɶ̆
ɶ̈	ɶ̈
ɶ̘	ɶ̘
ɶ̘ː	ɶ̘ː
ɶ̘ˠ	ɶ̘ˠ
ɶ̙	ɶ̙
ɶ̙ː	ɶ̙ː
ɶ̙ˠ	ɶ̙ˠ
ɶ̝	ɶ̝
ɶ̞	ɶ̞
ɶ̟	ɶ̟
ɶ̠	ɶ̠
ɶ̤	ɶ̤
ɶ̤ː	ɶ̤ː
ɶ̤ˠ	ɶ̤ˠ
ɶ̤ˤ	ɶ̤ˤ
ɶ̥̤	ɶ̤̥
ɶ̥	ɶ̥
ɶ̥ː	ɶ̥ː
ɶ̥ˠ	ɶ̥ˠ
ɶ̥ˤ	ɶ̥ˤ
ɶ̯	ɶ̯
ɶ̰	ɶ̰
ɶ̰ː	ɶ̰ː
ɶ̰ˠ	ɶ̰ˠ
ɶ̰ˤ	ɶ̰ˤ
ɶ̰̃	ɶ̰̃
ɸ	ɸ
ɸʰ	ɸʰ
ɸʲʰ	ɸʲʰ
ɸʷʰ	ɸʷʰ
ɸʰː	ɸʰː
ɸˠʰ	ɸʰˠ
ɸˤʰ	ɸˤʰ
ɸʲ	ɸʲ
ɸʲʷ	ɸʲʷ
ɸʲʷʰ	ɸʲʷʰ
ɸʼʲ	ɸʼʲ
ɸʲː	ɸːʲ
ɸʷ	ɸʷ
ɸʷʰː	ɸʷʰː
ɸʼʷ	ɸʼʷ
ɸʷˀ	ɸʷˀ
ɸʷː	ɸːʷ
ɸʷˠ	ɸʷˠ
ɸʷˠʰ	ɸʷˠʰ
ɸʷˤ	ɸʷˤ
ɸʷˤʰ	ɸʷˤʰ
ɸʼʷˤ	ɸʷˤʼ
ɸʼ	ɸʼ
ɸʼː	ɸʼː
ɸˀ	ɸˀ
ɸː	ɸː
ɸˠː	ɸːˠ
ɸˤː	ɸˤː
ɸˠ	ɸˠ
ɸˤ	ɸˤ
ɸʼˤ	ɸˤʼ
ɸ̝	ɸ̝
ɸ̞	ɸ̞
ɸ̟	ɸ̟
ɸ̠	ɸ̠
ɸ̩	ɸ̩
ɹ	ɹ
ɹʲ	ɹʲ
ɹʲʷ	ɹʲʷ
ɹʲː	ɹːʲ
ɹʷ	ɹʷ
ɹʷˀ	ɹʷˀ
ɹʷː	ɹːʷ
ɹʷˠ	ɹʷˠ
ɹʷˤ	ɹʷˤ
ɹˀ	ɹˀ
ɹː	ɹː
ɹˠː	ɹːˠ
ɹˤː	ɹˤː
ɹˠ	ɹˠ
ɹˤ	ɹˤ
ɹ̃	ɹ̃
ɹ̃ː	ɹ̃ː
ɹ̃ˤ	ɹ̃ˤ
ɹ̝	ɹ̝
ɹ̞	ɹ̞
ɹ̟	ɹ̟
ɹ̠	ɹ̠
ɹʱ	ɹ̤
ɹʲʱ	ɹ̤ʲ
ɹʷʱ	ɹ̤ʷ
ɹʱː	ɹ̤ː
ɹˠʱ	ɹ̤ˠ
ɹˤʱ	ɹ̤ˤ
ɹ̥ʱ	ɹ̤̥
ɹ̥	ɹ̥
ɹ̥ʲ	ɹ̥ʲ
ɹ̥ʷ	ɹ̥ʷ
ɹ̥ː	ɹ̥ː
ɹ̥ˠ	ɹ̥ˠ
ɹ̥ˤ	ɹ̥ˤ
ɹ̩	ɹ̩
ɹ̰	ɹ̰
ɹ̰ʲ	ɹ̰ʲ
ɹ̰ʷ	ɹ̰ʷ
ɹ̰ː	ɹ̰ː
ɹ̰ˠ	ɹ̰ˠ
ɹ̰ˤ	ɹ̰ˤ
ɹ̰̃	ɹ̰̃
ɹ̺	ɹ̺
ɹ̻	ɹ̻
ɹᶣ	ɹᶣ
ɺ	ɺ
ɺʲ	ɺʲ
ɺʲʷ	ɺʲʷ
ɺʲː	ɺːʲ
ɺʷ	ɺʷ
ɺʷˀ	ɺʷˀ
ɺʷː	ɺːʷ
ɺʷˠ	ɺʷˠ
ɺʷˤ	ɺʷˤ
ɺˀ	ɺˀ
ɺː	ɺː
ɺˠː	ɺːˠ
ɺˤː	ɺˤː
ɺˠ	ɺˠ
ɺˤ	ɺˤ
ɺ̃	ɺ̃
ɺ̃ː	ɺ̃ː
ɺ̃ˤ	ɺ̃ˤ
ɺ̝	ɺ̝
ɺ̞	ɺ̞
ɺ̟	ɺ̟
ɺ̠	ɺ̠
ɺʱ	ɺ̤
ɺʲʱ	ɺ̤ʲ
ɺʷʱ	ɺ̤ʷ
ɺʱː	ɺ̤ː
ɺˠʱ	ɺ̤ˠ
ɺˤʱ	ɺ̤ˤ
ɺ̥ʱ	ɺ̤̥
ɺ̥	ɺ̥
ɺ̥ʲ	ɺ̥ʲ
ɺ̥ʷ	ɺ̥ʷ
ɺ̥ː	ɺ̥ː
ɺ̥ˠ	ɺ̥ˠ
ɺ̥ˤ	ɺ̥ˤ
ɺ̩	ɺ̩
ɺ̰	ɺ̰
ɺ̰ʲ	ɺ̰ʲ
ɺ̰ʷ	ɺ̰ʷ
ɺ̰ː	ɺ̰ː
ɺ̰ˠ	ɺ̰ˠ
ɺ̰ˤ	ɺ̰ˤ
ɺ̰̃	ɺ̰̃
ɺ̺	ɺ̺
ɺ̻	ɺ̻
ɺᶣ	ɺᶣ
ɻ	ɻ
ɻʲ	ɻʲ
ɻʲʷ	ɻʲʷ
ɻʲː	ɻːʲ
ɻʷ	ɻʷ
ɻʷˀ	ɻʷˀ
ɻʷː	ɻːʷ
ɻʷˠ	ɻʷˠ
ɻʷˤ	ɻʷˤ
ɻˀ	ɻˀ
ɻː	ɻː
ɻˠː	ɻːˠ
ɻˤː	ɻˤː
ɻˠ	ɻˠ
ɻˤ	ɻˤ
ɻ̃	ɻ̃
ɻ̃ː	ɻ̃ː
ɻ̃ˤ	ɻ̃ˤ
ɻ̝	ɻ̝
ɻ̞	ɻ̞
ɻ̟	ɻ̟
ɻ̠	ɻ̠
ɻʱ	ɻ̤
ɻʲʱ	ɻ̤ʲ
ɻʷʱ	ɻ̤ʷ
ɻʱː	ɻ̤ː
ɻˠʱ	ɻ̤ˠ
ɻˤʱ	ɻ̤ˤ
ɻ̥ʱ	ɻ̤̥
ɻ̥	ɻ̥
ɻ̥ʲ	ɻ̥ʲ
ɻ̥ʷ	ɻ̥ʷ
ɻ̥ː	ɻ̥ː
ɻ̥ˠ	ɻ̥ˠ
ɻ̥ˤ	ɻ̥ˤ
ɻ̩	ɻ̩
ɻ̰	ɻ̰
ɻ̰ʲ	ɻ̰ʲ
ɻ̰ʷ	ɻ̰ʷ
ɻ̰ː	ɻ̰ː
ɻ̰ˠ	ɻ̰ˠ
ɻ̰ˤ	ɻ̰ˤ
ɻ̰̃	ɻ̰̃
ɻ̺	ɻ̺
ɻ̻	ɻ̻
ɻᶣ	ɻᶣ
ɽ	ɽ
ɽʲ	ɽʲ
ɽʲʷ	ɽʲʷ
ɽʲː	ɽːʲ
ɽʷ	ɽʷ
ɽʷˀ	ɽʷˀ
ɽʷː	ɽːʷ
ɽʷˠ	ɽʷˠ
ɽʷˤ	ɽʷˤ
ɽˀ	ɽˀ
ɽː	ɽː
ɽˠː	ɽːˠ
ɽˤː	ɽˤː
ɽˠ	ɽˠ
ɽˤ	ɽˤ
ɽ̃	ɽ̃
ɽ̃ː	ɽ̃ː
ɽ̃ˤ	ɽ̃ˤ
ɽ̝	ɽ̝
ɽ̞	ɽ̞
ɽ̟	ɽ̟
ɽ̠	ɽ̠
ɽʱ	ɽ̤
ɽʲʱ	ɽ̤ʲ
ɽʷʱ	ɽ̤ʷ
ɽʱː	ɽ̤ː
ɽˠʱ	ɽ̤ˠ
ɽˤʱ	ɽ̤ˤ
ɽ̥ʱ	ɽ̤̥
ɽ̥	ɽ̥
ɽ̥ʲ	ɽ̥ʲ
ɽ̥ʷ	ɽ̥ʷ
ɽ̥ː	ɽ̥ː
ɽ̥ˠ	ɽ̥ˠ
ɽ̥ˤ	ɽ̥ˤ
ɽ̩	ɽ̩
ɽ̰	ɽ̰
ɽ̰ʲ	ɽ̰ʲ
ɽ̰ʷ	ɽ̰ʷ
ɽ̰ː	ɽ̰ː
ɽ̰ˠ	ɽ̰ˠ
ɽ̰ˤ	ɽ̰ˤ
ɽ̰̃	ɽ̰̃
ɽ̺	ɽ̺
ɽ̻	ɽ̻
ɽᶣ	ɽᶣ
ɾ	ɾ
ɾʲ	ɾʲ
ɾʲʷ	ɾʲʷ
ɾʲː	ɾːʲ
ɾʷ	ɾʷ
ɾʷˀ	ɾʷˀ
ɾʷː	ɾːʷ
ɾʷˠ	ɾʷˠ
ɾʷˤ	ɾʷˤ
ɾˀ	ɾˀ
ɾː	ɾː
ɾˠː	ɾːˠ
ɾˤː	ɾˤː
ɾˠ	ɾˠ
ɾˤ	ɾˤ
ɾ̃	ɾ̃
ɾ̃ː	ɾ̃ː
ɾ̃ˤ	ɾ̃ˤ
ɾ̝	ɾ̝
ɾ̞	ɾ̞
ɾ̟	ɾ̟
ɾ̠	ɾ̠
ɾʱ	ɾ̤
ɾʲʱ	ɾ̤ʲ
ɾʷʱ	ɾ̤ʷ
ɾʱː	ɾ̤ː
ɾˠʱ	ɾ̤ˠ
ɾˤʱ	ɾ̤ˤ
ɾ̥ʱ	ɾ̤̥
ɾ̥	ɾ̥
ɾ̥ʲ	ɾ̥ʲ
ɾ̥ʷ	ɾ̥ʷ
ɾ̥ː	ɾ̥ː
ɾ̥ˠ	ɾ̥ˠ
ɾ̥ˤ	ɾ̥ˤ
ɾ̩	ɾ̩
ɾ̰	ɾ̰
ɾ̰ʲ	ɾ̰ʲ
ɾ̰ʷ	ɾ̰ʷ
ɾ̰ː	ɾ̰ː
ɾ̰ˠ	ɾ̰ˠ
ɾ̰ˤ	ɾ̰ˤ
ɾ̰̃	ɾ̰̃
ɾ̺	ɾ̺
ɾ̻	ɾ̻
ɾᶣ	ɾᶣ
ʀ	ʀ
ʀʲ	ʀʲ
ʀʲʷ	ʀʲʷ
ʀʲː	ʀːʲ
ʀʷ	ʀʷ
ʀʷˀ	ʀʷˀ
ʀʷː	ʀːʷ
ʀʷˠ	ʀʷˠ
ʀʷˤ	ʀʷˤ
ʀˀ	ʀˀ
ʀː	ʀː
ʀˠː	ʀːˠ
ʀˤː	ʀˤː
ʀˠ	ʀˠ
ʀˤ	ʀˤ
ʀ̃	ʀ̃
ʀ̃ː	ʀ̃ː
ʀ̃ˤ	ʀ̃ˤ
ʀ̝	ʀ̝
ʀ̞	ʀ̞
ʀ̟	ʀ̟
ʀ̠	ʀ̠
ʀʱ	ʀ̤
ʀʲʱ	ʀ̤ʲ
ʀʷʱ	ʀ̤ʷ
ʀʱː	ʀ̤ː
ʀˠʱ	ʀ̤ˠ
ʀˤʱ	ʀ̤ˤ
ʀ̥ʱ	ʀ̤̥
ʀ̥	ʀ̥
ʀ̥ʲ	ʀ̥ʲ
ʀ̥ʷ	ʀ̥ʷ
ʀ̥ː	ʀ̥ː
ʀ̥ˠ	ʀ̥ˠ
ʀ̥ˤ	ʀ̥ˤ
ʀ̩	ʀ̩
ʀ̰	ʀ̰
ʀ̰ʲ	ʀ̰ʲ
ʀ̰ʷ	ʀ̰ʷ
ʀ̰ː	ʀ̰ː
ʀ̰ˠ	ʀ̰ˠ
ʀ̰ˤ	ʀ̰ˤ
ʀ̰̃	ʀ̰̃
ʀᶣ	ʀᶣ
ʁ	ʁ
ʁʲ	ʁʲ
ʁʲʷ	ʁʲʷ
ʁʲː	ʁːʲ
ʁʷ	ʁʷ
ʁʷˀ	ʁʷˀ
ʁʷː	ʁːʷ
ʁʷˠ	ʁʷˠ
ʁʷˤ	ʁʷˤ
ʁˀ	ʁˀ
ʁː	ʁː
ʁˠː	ʁːˠ
ʁˤː	ʁˤː
ʁˠ	ʁˠ
ʁˤ	ʁˤ
ʁ̃	ʁ̃
ʁ̃ː	ʁ̃ː
ʁ̃ˤ	ʁ̃ˤ
ʁ̝	ʁ̝
ʁ̞	ʁ̞
ʁ̟	ʁ̟
ʁ̠	ʁ̠
ʁʱ	ʁ̤
ʁʲʱ	ʁ̤ʲ
ʁʷʱ	ʁ̤ʷ
ʁʱː	ʁ̤ː
ʁˠʱ	ʁ̤ˠ
ʁˤʱ	ʁ̤ˤ
ʁ̩	ʁ̩
ʁ̰	ʁ̰
ʁ̰ʲ	ʁ̰ʲ
ʁ̰ʷ	ʁ̰ʷ
ʁ̰ː	ʁ̰ː
ʁ̰ˠ	ʁ̰ˠ
ʁ̰ˤ	ʁ̰ˤ
ʁ̰̃	ʁ̰̃
ʁᶣ	ʁᶣ
ʂ	ʂ
ʂʰ	ʂʰ
ʂʲʰ	ʂʲʰ
ʂʷʰ	ʂʷʰ
ʂʰː	ʂʰː
ʂˠʰ	ʂʰˠ
ʂˤʰ	ʂˤʰ
ʂᶣʰ	ʂʰᶣ
ʂʲ	ʂʲ
ʂʲʷ	ʂʲʷ
ʂʲʷʰ	ʂʲʷʰ
ʂʼʲ	ʂʼʲ
ʂʲː	ʂːʲ
ʂʷ	ʂʷ
ʂʷʰː	ʂʷʰː
ʂʼʷ	ʂʼʷ
ʂʷˀ	ʂʷˀ
ʂʷː	ʂːʷ
ʂʷˠ	ʂʷˠ
ʂʷˠʰ	ʂʷˠʰ
ʂʷˤ	ʂʷˤ
ʂʷˤʰ	ʂʷˤʰ
ʂʼʷˤ	ʂʷˤʼ
ʂʼ	ʂʼ
ʂʼː	ʂʼː
ʂˀ	ʂˀ
ʂː	ʂː
ʂˠː	ʂːˠ
ʂˤː	ʂˤː
ʂˠ	ʂˠ
ʂˤ	ʂˤ
ʂʼˤ	ʂˤʼ
ʂ̝	ʂ̝
ʂ̞	ʂ̞
ʂ̟	ʂ̟
ʂ̠	ʂ̠
ʂ̩	ʂ̩
ʂ̺	ʂ̺
ʂ̻	ʂ̻
ʂᶣ	ʂᶣ
ʃ	ʃ
ʃʰ	ʃʰ
ʃʲʰ	ʃʲʰ
ʃʷʰ	ʃʷʰ
ʃʰː	ʃʰː
ʃˠʰ	ʃʰˠ
ʃˤʰ	ʃˤʰ
ʃᶣʰ	ʃʰᶣ
ʃʲ	ʃʲ
ʃʲʷ	ʃʲʷ
ʃʲʷʰ	ʃʲʷʰ
ʃʼʲ	ʃʼʲ
ʃʲː	ʃːʲ
ʃʷ	ʃʷ
ʃʷʰː	ʃʷʰː
ʃʼʷ	ʃʼʷ
ʃʷˀ	ʃʷˀ
ʃʷː	ʃːʷ
ʃʷˠ	ʃʷˠ
ʃʷˠʰ	ʃʷˠʰ
ʃʷˤ	ʃʷˤ
ʃʷˤʰ	ʃʷˤʰ
ʃʼʷˤ	ʃʷˤʼ
ʃʼ	ʃʼ
ʃʼː	ʃʼː
ʃˀ	ʃˀ
ʃː	ʃː
ʃˠː	ʃːˠ
ʃˤː	ʃˤː
ʃˠ	ʃˠ
ʃˤ	ʃˤ
ʃʼˤ	ʃˤʼ
ʃ̝	ʃ̝
ʃ̞	ʃ̞
ʃ̟	ʃ̟
ʃ̠	ʃ̠
ʃ̩	ʃ̩
ʃ̺	ʃ̺
ʃ̻	ʃ̻
ʃᶣ	ʃᶣ
ʄ	ʄ
ʄʲ	ʄʲ
ʄʲʷ	ʄʲʷ
ʄʲː	ʄːʲ
ʄʷ	ʄʷ
ʄʷː	ʄːʷ
ʄʷˠ	ʄʷˠ
ʄʷˤ	ʄʷˤ
ʄː	ʄː
ʄˠː	ʄːˠ
ʄˤː	ʄˤː
ʄˠ	ʄˠ
ʄˤ	ʄˤ
ʄ̃	ʄ̃
ʄ̃ː	ʄ̃ː
ʄ̃ˤ	ʄ̃ˤ
ʄ̟	ʄ̟
ʄ̠	ʄ̠
ʄʱ	ʄ̤
ʄʲʱ	ʄ̤ʲ
ʄʷʱ	ʄ̤ʷ
ʄʱː	ʄ̤ː
ʄˠʱ	ʄ̤ˠ
ʄˤʱ	ʄ̤ˤ
ʄ̰	ʄ̰
ʄ̰ʲ	ʄ̰ʲ
ʄ̰ʷ	ʄ̰ʷ
ʄ̰ː	ʄ̰ː
ʄ̰ˠ	ʄ̰ˠ
ʄ̰ˤ	ʄ̰ˤ
ʄ̰̃	ʄ̰̃
ʄᶣ	ʄᶣ
ʄⁿ	ʄⁿ
ʈ	ʈ
ʈʰ	ʈʰ
ʈʲʰ	ʈʲʰ
ʈʷʰ	ʈʷʰ
ʈʰː	ʈʰː
ʈˠʰ	ʈʰˠ
ʈˤʰ	ʈˤʰ
ʈᶣʰ	ʈʰᶣ
ʈʲ	ʈʲ
ʈʲʷ	ʈʲʷ
ʈʲʷʰ	ʈʲʷʰ
ʈʼʲ	ʈʼʲ
ʈʲː	ʈːʲ
ʈʷ	ʈʷ
ʈʷʰː	ʈʷʰː
ʈʼʷ	ʈʼʷ
ʈʷˀ	ʈʷˀ
ʈʷː	ʈːʷ
ʈʷˠ	ʈʷˠ
ʈʷˠʰ	ʈʷˠʰ
ʈʷˤ	ʈʷˤ
ʈʷˤʰ	ʈʷˤʰ
ʈʼʷˤ	ʈʷˤʼ
ʈʼ	ʈʼ
ʈʼː	ʈʼː
ʈˀ	ʈˀ
ʈː	ʈː
ʈˠː	ʈːˠ
ʈˤː	ʈˤː
ʈˠ	ʈˠ
ʈˡ	ʈˡ
ʈˤ	ʈˤ
ʈʼˤ	ʈˤʼ
ʈ̟	ʈ̟
ʈ̠	ʈ̠
ʈ̺	ʈ̺
ʈ̻	ʈ̻
ʈʂ	ʈ͡ʂ
ʈʂʰ	ʈ͡ʂʰ
ʈʂʲʰ	ʈ͡ʂʲʰ
ʈʂʷʰ	ʈ͡ʂʷʰ
ʈʂʰː	ʈ͡ʂʰː
ʈʂˠʰ	ʈ͡ʂʰˠ
ʈʂˤʰ	ʈ͡ʂˤʰ
ʈʂᶣʰ	ʈ͡ʂʰᶣ
ʈʂʲ	ʈ͡ʂʲ
ʈʂʲʷ	ʈ͡ʂʲʷ
ʈʂʲʷʰ	ʈ͡ʂʲʷʰ
ʈʂʼʲ	ʈ͡ʂʼʲ
ʈʂʲː	ʈ͡ʂʲː
ʈʂʷ	ʈ͡ʂʷ
ʈʂʷʰː	ʈ͡ʂʷʰː
ʈʂʼʷ	ʈ͡ʂʼʷ
ʈʂʷˀ	ʈ͡ʂʷˀ
ʈʂʷː	ʈ͡ʂʷː
ʈʂʷˠ	ʈ͡ʂʷˠ
ʈʂʷˠʰ	ʈ͡ʂʷˠʰ
ʈʂʷˤ	ʈ͡ʂʷˤ
ʈʂʷˤʰ	ʈ͡ʂʷˤʰ
ʈʂʼʷˤ	ʈ͡ʂʷˤʼ
ʈʂʼ	ʈ͡ʂʼ
ʈʂʼː	ʈ͡ʂʼː
ʈʂˀ	ʈ͡ʂˀ
ʈʂː	ʈ͡ʂː
ʈʂˠ	ʈ͡ʂˠ
ʈʂˤ	ʈ͡ʂˤ
ʈʂʼˤ	ʈ͡ʂˤʼ
ʈʂˤː	ʈ͡ʂˤː
ʈʂ̟	ʈ͡ʂ̟
ʈʂ̠	ʈ͡ʂ̠
ʈʂ̺	ʈ͡ʂ̺
ʈʂ̻	ʈ͡ʂ̻
ʈʂᶣ	ʈ͡ʂᶣ
ʈᶣ	ʈᶣ
ʈⁿ	ʈⁿ
ʉ	ʉ
ʉː	ʉː
ʉˠː	ʉːˠ
ʉˤː	ʉˤː
ʉ˞	ʉ˞
ʉˠ	ʉˠ
ʉˤ	ʉˤ
ʉ̃	ʉ̃
ʉ̃ː	ʉ̃ː
ʉ̃ˤ	ʉ̃ˤ
ʉ̆	ʉ̆
ʉ̈	ʉ̈
ʉ̘	ʉ̘
ʉ̘ː	ʉ̘ː
ʉ̘ˠ	ʉ̘ˠ
ʉ̙	ʉ̙
ʉ̙ː	ʉ̙ː
ʉ̙ˠ	ʉ̙ˠ
ʉ̝	ʉ̝
ʉ̞	ʉ̞
ʉ̟	ʉ̟
ʉ̠	ʉ̠
ʉ̤	ʉ̤
ʉ̤ː	ʉ̤ː
ʉ̤ˠ	ʉ̤ˠ
ʉ̤ˤ	ʉ̤ˤ
ʉ̥̤	ʉ̤̥
ʉ̥	ʉ̥
ʉ̥ː	ʉ̥ː
ʉ̥ˠ	ʉ̥ˠ
ʉ̥ˤ	ʉ̥ˤ
ʉ̯	ʉ̯
ʉ̰	ʉ̰
ʉ̰ː	ʉ̰ː
ʉ̰ˠ	ʉ̰ˠ
ʉ̰ˤ	ʉ̰ˤ
ʉ̰̃	ʉ̰̃
ʊ	ʊ
ʊː	ʊː
ʊˤː	ʊˤː
ʊ˞	ʊ˞
ʊˤ	ʊˤ
ʊ̃	ʊ̃
ʊ̃ː	ʊ̃ː
ʊ̃ˤ	ʊ̃ˤ
ʊ̆	ʊ̆
ʊ̈	ʊ̈
ʊ̘	ʊ̘
ʊ̘ː	ʊ̘ː
ʊ̙	ʊ̙
ʊ̙ː	ʊ̙ː
ʊ̝	ʊ̝
ʊ̞	ʊ̞
ʊ̟	ʊ̟
ʊ̠	ʊ̠
ʊ̤	ʊ̤
ʊ̤ː	ʊ̤ː
ʊ̤ˤ	ʊ̤ˤ
ʊ̥̤	ʊ̤̥
ʊ̥	ʊ̥
ʊ̥ː	ʊ̥ː
ʊ̥ˤ	ʊ̥ˤ
ʊ̯	ʊ̯
ʊ̰	ʊ̰
ʊ̰ː	ʊ̰ː
ʊ̰ˤ	ʊ̰ˤ
ʊ̰̃	ʊ̰̃
ʋ	ʋ
ʋʲ	ʋʲ
ʋʲʷ	ʋʲʷ
ʋʲː	ʋːʲ
ʋʷ	ʋʷ
ʋʷˀ	ʋʷˀ
ʋʷː	ʋːʷ
ʋʷˠ	ʋʷˠ
ʋʷˤ	ʋʷˤ
ʋˀ	ʋˀ
ʋː	ʋː
ʋˠː	ʋːˠ
ʋˤː	ʋˤː
ʋˠ	ʋˠ
ʋˤ	ʋˤ
ʋ̃	ʋ̃
ʋ̃ː	ʋ̃ː
ʋ̃ˤ	ʋ̃ˤ
ʋ̝	ʋ̝
ʋ̞	ʋ̞
ʋ̟	ʋ̟
ʋ̠	ʋ̠
ʋʱ	ʋ̤
ʋʲʱ	ʋ̤ʲ
ʋʷʱ	ʋ̤ʷ
ʋʱː	ʋ̤ː
ʋˠʱ	ʋ̤ˠ
ʋˤʱ	ʋ̤ˤ
ʋ̥ʱ	ʋ̤̥
ʋ̥	ʋ̥
ʋ̥ʲ	ʋ̥ʲ
ʋ̥ʷ	ʋ̥ʷ
ʋ̥ː	ʋ̥ː
ʋ̥ˠ	ʋ̥ˠ
ʋ̥ˤ	ʋ̥ˤ
ʋ̩	ʋ̩
ʋ̰	ʋ̰
ʋ̰ʲ	ʋ̰ʲ
ʋ̰ʷ	ʋ̰ʷ
ʋ̰ː	ʋ̰ː
ʋ̰ˠ	ʋ̰ˠ
ʋ̰ˤ	ʋ̰ˤ
ʋ̰̃	ʋ̰̃
ʌ	ʌ
ʌː	ʌː
ʌˠː	ʌːˠ
ʌˤː	ʌˤː
ʌ˞	ʌ˞
ʌˠ	ʌˠ
ʌˤ	ʌˤ
ʌ̃	ʌ̃
ʌ̃ː	ʌ̃ː
ʌ̃ˤ	ʌ̃ˤ
ʌ̆	ʌ̆
ʌ̈	ʌ̈
ʌ̘	ʌ̘
ʌ̘ː	ʌ̘ː
ʌ̘ˠ	ʌ̘ˠ
ʌ̙	ʌ̙
ʌ̙ː	ʌ̙ː
ʌ̙ˠ	ʌ̙ˠ
ʌ̝	ʌ̝
ʌ̞	ʌ̞
ʌ̟	ʌ̟
ʌ̠	ʌ̠
ʌ̤	ʌ̤
ʌ̤ː	ʌ̤ː
ʌ̤ˠ	ʌ̤ˠ
ʌ̤ˤ	ʌ̤ˤ
ʌ̥̤	ʌ̤̥
ʌ̥	ʌ̥
ʌ̥ː	ʌ̥ː
ʌ̥ˠ	ʌ̥ˠ
ʌ̥ˤ	ʌ̥ˤ
ʌ̯	ʌ̯
ʌ̰	ʌ̰
ʌ̰ː	ʌ̰ː
ʌ̰ˠ	ʌ̰ˠ
ʌ̰ˤ	ʌ̰ˤ
ʌ̰̃	ʌ̰̃
ʍ	ʍ
ʍʲ	ʍʲ
ʍʲʷ	ʍʲʷ
ʍʲː	ʍːʲ
ʍˀ	ʍˀ
ʍː	ʍː
ʍʷː	ʍːʷ
ʍˠː	ʍːˠ
ʍˤː	ʍˤː
ʍˠ	ʍˠ
ʍˤ	ʍˤ
ʍ̝	ʍ̝
ʍ̞	ʍ̞
ʍ̟	ʍ̟
ʍ̠	ʍ̠
ʍ̩	ʍ̩
ʎ	ʎ
ʎʲ	ʎʲ
ʎʲʷ	ʎʲʷ
ʎʲː	ʎːʲ
ʎʷ	ʎʷ
ʎʷˀ	ʎʷˀ
ʎʷː	ʎːʷ
ʎʷˠ	ʎʷˠ
ʎʷˤ	ʎʷˤ
ʎˀ	ʎˀ
ʎː	ʎː
ʎˠː	ʎːˠ
ʎˤː	ʎˤː
ʎˠ	ʎˠ
ʎˤ	ʎˤ
ʎ̃	ʎ̃
ʎ̃ː	ʎ̃ː
ʎ̃ˤ	ʎ̃ˤ
ʎ̝	ʎ̝
ʎ̞	ʎ̞
ȴ	ʎ̟
ʎ̠	ʎ̠
ʎʱ	ʎ̤
ʎʲʱ	ʎ̤ʲ
ʎʷʱ	ʎ̤ʷ
ʎʱː	ʎ̤ː
ʎˠʱ	ʎ̤ˠ
ʎˤʱ	ʎ̤ˤ
ʎ̥ʱ	ʎ̤̥
ʎ̥	ʎ̥
ʎ̥ʲ	ʎ̥ʲ
ʎ̥ʷ	ʎ̥ʷ
ʎ̥ː	ʎ̥ː
ʎ̥ˠ	ʎ̥ˠ
ʎ̥ˤ	ʎ̥ˤ
ʎ̩	ʎ̩
ʎ̰	ʎ̰
ʎ̰ʲ	ʎ̰ʲ
ʎ̰ʷ	ʎ̰ʷ
ʎ̰ː	ʎ̰ː
ʎ̰ˠ	ʎ̰ˠ
ʎ̰ˤ	ʎ̰ˤ
ʎ̰̃	ʎ̰̃
ʎ̺	ʎ̺
ʎ̻	ʎ̻
ʎᶣ	ʎᶣ
ʏ	ʏ
ʏː	ʏː
ʏˠː	ʏːˠ
ʏˤː	ʏˤː
ʏ˞	ʏ˞
ʏˠ	ʏˠ
ʏˤ	ʏˤ
ʏ̃	ʏ̃
ʏ̃ː	ʏ̃ː
ʏ̃ˤ	ʏ̃ˤ
ʏ̆	ʏ̆
ʏ̈	ʏ̈
ʏ̘	ʏ̘
ʏ̘ː	ʏ̘ː
ʏ̘ˠ	ʏ̘ˠ
ʏ̙	ʏ̙
ʏ̙ː	ʏ̙ː
ʏ̙ˠ	ʏ̙ˠ
ʏ̝	ʏ̝
ʏ̞	ʏ̞
ʏ̟	ʏ̟
ʏ̠	ʏ̠
ʏ̤	ʏ̤
ʏ̤ː	ʏ̤ː
ʏ̤ˠ	ʏ̤ˠ
ʏ̤ˤ	ʏ̤ˤ
ʏ̥̤	ʏ̤̥
ʏ̥	ʏ̥
ʏ̥ː	ʏ̥ː
ʏ̥ˠ	ʏ̥ˠ
ʏ̥ˤ	ʏ̥ˤ
ʏ̯	ʏ̯
ʏ̰	ʏ̰
ʏ̰ː	ʏ̰ː
ʏ̰ˠ	ʏ̰ˠ
ʏ̰ˤ	ʏ̰ˤ
ʏ̰̃	ʏ̰̃
ʐ	ʐ
ʐʲ	ʐʲ
ʐʲʷ	ʐʲʷ
ʐʲː	ʐːʲ
ʐʷ	ʐʷ
ʐʷˀ	ʐʷˀ
ʐʷː	ʐːʷ
ʐʷˠ	ʐʷˠ
ʐʷˤ	ʐʷˤ
ʐˀ	ʐˀ
ʐː	ʐː
ʐˠː	ʐːˠ
ʐˤː	ʐˤː
ʐˠ	ʐˠ
ʐˤ	ʐˤ
ʐ̃	ʐ̃
ʐ̃ː	ʐ̃ː
ʐ̃ˤ	ʐ̃ˤ
ʐ̝	ʐ̝
ʐ̞	ʐ̞
ʐ̟	ʐ̟
ʐ̠	ʐ̠
ʐʱ	ʐ̤
ʐʲʱ	ʐ̤ʲ
ʐʷʱ	ʐ̤ʷ
ʐʱː	ʐ̤ː
ʐˠʱ	ʐ̤ˠ
ʐˤʱ	ʐ̤ˤ
ʐ̩	ʐ̩
ʐ̰	ʐ̰
ʐ̰ʲ	ʐ̰ʲ
ʐ̰ʷ	ʐ̰ʷ
ʐ̰ː	ʐ̰ː
ʐ̰ˠ	ʐ̰ˠ
ʐ̰ˤ	ʐ̰ˤ
ʐ̰̃	ʐ̰̃
ʐ̺	ʐ̺
ʐ̻	ʐ̻
ʐᶣ	ʐᶣ
ʑ	ʑ
ʑʲ	ʑʲ
ʑʲʷ	ʑʲʷ
ʑʲː	ʑːʲ
ʑʷ	ʑʷ
ʑʷˀ	ʑʷˀ
ʑʷː	ʑːʷ
ʑʷˠ	ʑʷˠ
ʑʷˤ	ʑʷˤ
ʑˀ	ʑˀ
ʑː	ʑː
ʑˠː	ʑːˠ
ʑˤː	ʑˤː
ʑˠ	ʑˠ
ʑˤ	ʑˤ
ʑ̃	ʑ̃
ʑ̃ː	ʑ̃ː
ʑ̃ˤ	ʑ̃ˤ
ʑ̝	ʑ̝
ʑ̞	ʑ̞
ʑ̟	ʑ̟
ʑ̠	ʑ̠
ʑʱ	ʑ̤
ʑʲʱ	ʑ̤ʲ
ʑʷʱ	ʑ̤ʷ
ʑʱː	ʑ̤ː
ʑˠʱ	ʑ̤ˠ
ʑˤʱ	ʑ̤ˤ
ʑ̰	ʑ̰
ʑ̰ʲ	ʑ̰ʲ
ʑ̰ʷ	ʑ̰ʷ
ʑ̰ː	ʑ̰ː
ʑ̰ˠ	ʑ̰ˠ
ʑ̰ˤ	ʑ̰ˤ
ʑ̰̃	ʑ̰̃
ʑ̺	ʑ̺
ʑ̻	ʑ̻
ʑᶣ	ʑᶣ
ʒ	ʒ
ʒʲ	ʒʲ
ʒʲʷ	ʒʲʷ
ʒʲː	ʒːʲ
ʒʷ	ʒʷ
ʒʷˀ	ʒʷˀ
ʒʷː	ʒːʷ
ʒʷˠ	ʒʷˠ
ʒʷˤ	ʒʷˤ
ʒˀ	ʒˀ
ʒː	ʒː
ʒˠː	ʒːˠ
ʒˤː	ʒˤː
ʒˠ	ʒˠ
ʒˤ	ʒˤ
ʒ̃	ʒ̃
ʒ̃ː	ʒ̃ː
ʒ̃ˤ	ʒ̃ˤ
ʒ̝	ʒ̝
ʒ̞	ʒ̞
ʒ̟	ʒ̟
ʒ̠	ʒ̠
ʒʱ	ʒ̤
ʒʲʱ	ʒ̤ʲ
ʒʷʱ	ʒ̤ʷ
ʒʱː	ʒ̤ː
ʒˠʱ	ʒ̤ˠ
ʒˤʱ	ʒ̤ˤ
ʒ̍	ʒ̩
ʒ̰	ʒ̰
ʒ̰ʲ	ʒ̰ʲ
ʒ̰ʷ	ʒ̰ʷ
ʒ̰ː	ʒ̰ː
ʒ̰ˠ	ʒ̰ˠ
ʒ̰ˤ	ʒ̰ˤ
ʒ̰̃	ʒ̰̃
ʒ̺	ʒ̺
ʒ̻	ʒ̻
ʒᶣ	ʒᶣ
ʔ	ʔ
ʔʲ	ʔʲ
ʔʲʷ	ʔʲʷ
ʔʲː	ʔːʲ
ʔʷ	ʔʷ
ʔʷː	ʔːʷ
ʔʷˠ	ʔʷˠ
ʔʷˤ	ʔʷˤ
ʔː	ʔː
ʔˠː	ʔːˠ
ʔˤː	ʔːˤ
ʔˠ	ʔˠ
ʔ̟	ʔ̟
ʔ̠	ʔ̠
ʔᶣ	ʔᶣ
ʕ	ʕ
ʕʲ	ʕʲ
ʕʲʷ	ʕʲʷ
ʕʲː	ʕːʲ
ʕʷ	ʕʷ
ʕʷˀ	ʕʷˀ
ʕʷː	ʕːʷ
ʕʷˠ	ʕʷˠ
ʕʷˤ	ʕʷˤ
ʕˀ	ʕˀ
ʕː	ʕː
ʕˠː	ʕːˠ
ʕˤː	ʕːˤ
ʕˠ	ʕˠ
ʕ̃	ʕ̃
ʕ̃ː	ʕ̃ː
ʕ̃ˤ	ʕ̃ˤ
ʕ̝	ʕ̝
ʕ̞	ʕ̞
ʕ̟	ʕ̟
ʕ̠	ʕ̠
ʕʱ	ʕ̤
ʕʲʱ	ʕ̤ʲ
ʕʷʱ	ʕ̤ʷ
ʕʱː	ʕ̤ː
ʕˠʱ	ʕ̤ˠ
ʕˤʱ	ʕ̤ˤ
ʕ̩	ʕ̩
ʕ̰	ʕ̰
ʕ̰ʲ	ʕ̰ʲ
ʕ̰ʷ	ʕ̰ʷ
ʕ̰ː	ʕ̰ː
ʕ̰ˠ	ʕ̰ˠ
ʕ̰ˤ	ʕ̰ˤ
ʕ̰̃	ʕ̰̃
ʕᶣ	ʕᶣ
ʘ	ʘ
ʘʰ	ʘʰ
ʘʲʰ	ʘʲʰ
ʘʷʰ	ʘʷʰ
ʘʰː	ʘʰː
ʘˠʰ	ʘʰˠ
ʘˤʰ	ʘˤʰ
ʘʲ	ʘʲ
ʘʲʷ	ʘʲʷ
ʘʲʷʰ	ʘʲʷʰ
ʘʼʲ	ʘʼʲ
ʘʲː	ʘːʲ
ʘʷ	ʘʷ
ʘʷʰː	ʘʷʰː
ʘʼʷ	ʘʼʷ
ʘʷˀ	ʘʷˀ
ʘʷː	ʘːʷ
ʘʷˠ	ʘʷˠ
ʘʷˠʰ	ʘʷˠʰ
ʘʷˤ	ʘʷˤ
ʘʷˤʰ	ʘʷˤʰ
ʘʼʷˤ	ʘʷˤʼ
ʘʼ	ʘʼ
ʘʼː	ʘʼː
ʘˀ	ʘˀ
ʘː	ʘː
ʘˠː	ʘːˠ
ʘˤː	ʘˤː
ʘˠ	ʘˠ
ʘˤ	ʘˤ
ʘʼˤ	ʘˤʼ
ʘ̟	ʘ̟
ʘ̠	ʘ̠
ʘⁿ	ʘⁿ
ʙ	ʙ
ʙʲ	ʙʲ
ʙʲʷ	ʙʲʷ
ʙʲː	ʙːʲ
ʙʷ	ʙʷ
ʙʷˀ	ʙʷˀ
ʙʷː	ʙːʷ
ʙʷˠ	ʙʷˠ
ʙʷˤ	ʙʷˤ
ʙˀ	ʙˀ
ʙː	ʙː
ʙˠː	ʙːˠ
ʙˤː	ʙˤː
ʙˠ	ʙˠ
ʙˤ	ʙˤ
ʙ̃	ʙ̃
ʙ̃ː	ʙ̃ː
ʙ̃ˤ	ʙ̃ˤ
ʙ̝	ʙ̝
ʙ̞	ʙ̞
ʙ̟	ʙ̟
ʙ̠	ʙ̠
ʙʱ	ʙ̤
ʙʲʱ	ʙ̤ʲ
ʙʷʱ	ʙ̤ʷ
ʙʱː	ʙ̤ː
ʙˠʱ	ʙ̤ˠ
ʙˤʱ	ʙ̤ˤ
ʙ̥ʱ	ʙ̤̥
ʙ̥	ʙ̥
ʙ̥ʲ	ʙ̥ʲ
ʙ̥ʷ	ʙ̥ʷ
ʙ̥ː	ʙ̥ː
ʙ̥ˠ	ʙ̥ˠ
ʙ̥ˤ	ʙ̥ˤ
ʙ̩	ʙ̩
ʙ̰	ʙ̰
ʙ̰ʲ	ʙ̰ʲ
ʙ̰ʷ	ʙ̰ʷ
ʙ̰ː	ʙ̰ː
ʙ̰ˠ	ʙ̰ˠ
ʙ̰ˤ	ʙ̰ˤ
ʙ̰̃	ʙ̰̃
ʛ	ʛ
ʛʲ	ʛʲ
ʛʲʷ	ʛʲʷ
ʛʲː	ʛːʲ
ʛʷ	ʛʷ
ʛʷː	ʛːʷ
ʛʷˠ	ʛʷˠ
ʛʷˤ	ʛʷˤ
ʛː	ʛː
ʛˠː	ʛːˠ
ʛˤː	ʛˤː
ʛˠ	ʛˠ
ʛˤ	ʛˤ
ʛ̃	ʛ̃
ʛ̃ː	ʛ̃ː
ʛ̃ˤ	ʛ̃ˤ
ʛ̟	ʛ̟
ʛ̠	ʛ̠
ʛʱ	ʛ̤
ʛʲʱ	ʛ̤ʲ
ʛʷʱ	ʛ̤ʷ
ʛʱː	ʛ̤ː
ʛˠʱ	ʛ̤ˠ
ʛˤʱ	ʛ̤ˤ
ʛ̰	ʛ̰
ʛ̰ʲ	ʛ̰ʲ
ʛ̰ʷ	ʛ̰ʷ
ʛ̰ː	ʛ̰ː
ʛ̰ˠ	ʛ̰ˠ
ʛ̰ˤ	ʛ̰ˤ
ʛ̰̃	ʛ̰̃
ʛᶣ	ʛᶣ
ʛⁿ	ʛⁿ
ʝ	ʝ
ʝʲ	ʝʲ
ʝʲʷ	ʝʲʷ
ʝʲː	ʝːʲ
ʝʷ	ʝʷ
ʝʷˀ	ʝʷˀ
ʝʷː	ʝːʷ
ʝʷˠ	ʝʷˠ
ʝʷˤ	ʝʷˤ
ʝˀ	ʝˀ
ʝː	ʝː
ʝˠː	ʝːˠ
ʝˤː	ʝˤː
ʝˠ	ʝˠ
ʝˤ	ʝˤ
ʝ̃	ʝ̃
ʝ̃ː	ʝ̃ː
ʝ̃ˤ	ʝ̃ˤ
ʝ̝	ʝ̝
ʝ̞	ʝ̞
ʝ̟	ʝ̟
ʝ̠	ʝ̠
ʝʱ	ʝ̤
ʝʲʱ	ʝ̤ʲ
ʝʷʱ	ʝ̤ʷ
ʝʱː	ʝ̤ː
ʝˠʱ	ʝ̤ˠ
ʝˤʱ	ʝ̤ˤ
ʝ̩	ʝ̩
ʝ̰	ʝ̰
ʝ̰ʲ	ʝ̰ʲ
ʝ̰ʷ	ʝ̰ʷ
ʝ̰ː	ʝ̰ː
ʝ̰ˠ	ʝ̰ˠ
ʝ̰ˤ	ʝ̰ˤ
ʝ̰̃	ʝ̰̃
ʝᶣ	ʝᶣ
ʟ	ʟ
ʟʲ	ʟʲ
ʟʲʷ	ʟʲʷ
ʟʲː	ʟːʲ
ʟʷ	ʟʷ
ʟʷˀ	ʟʷˀ
ʟʷː	ʟːʷ
ʟʷˠ	ʟʷˠ
ʟʷˤ	ʟʷˤ
ʟˀ	ʟˀ
ʟː	ʟː
ʟˠː	ʟːˠ
ʟˤː	ʟˤː
ʟˤ	ʟˤ
ʟ̃	ʟ̃
ʟ̃ː	ʟ̃ː
ʟ̃ˤ	ʟ̃ˤ
ʟ̝	ʟ̝
ʟ̞	ʟ̞
ʟ̟	ʟ̟
ʟ̠	ʟ̠
ʟʱ	ʟ̤
ʟʲʱ	ʟ̤ʲ
ʟʷʱ	ʟ̤ʷ
ʟʱː	ʟ̤ː
ʟˠʱ	ʟ̤ˠ
ʟˤʱ	ʟ̤ˤ
ʟ̥ʱ	ʟ̤̥
ʟ̥	ʟ̥
ʟ̥ʲ	ʟ̥ʲ
ʟ̥ʷ	ʟ̥ʷ
ʟ̥ː	ʟ̥ː
ʟ̥ˠ	ʟ̥ˠ
ʟ̥ˤ	ʟ̥ˤ
ʟ̩	ʟ̩
ʟ̰	ʟ̰
ʟ̰ʲ	ʟ̰ʲ
ʟ̰ʷ	ʟ̰ʷ
ʟ̰ː	ʟ̰ː
ʟ̰ˠ	ʟ̰ˠ
ʟ̰ˤ	ʟ̰ˤ
ʟ̰̃	ʟ̰̃
ʟᶣ	ʟᶣ
ˀb	ˀb
ˀbd	ˀb͡d
ˀbv	ˀb͡v
ˀbβ	ˀb͡β
ˀc	ˀc
ˀcç	ˀc͡ç
ˀd	ˀd
ˀd̪	ˀd̪
ˀdz̪	ˀd̪͡z̪
ˀdð	ˀd̪͡ð
ˀd̪ɮ	ˀd̪͡ɮ̪
ˀdz	ˀd͡z
ˀdɮ	ˀd͡ɮ
ˀdʑ	ˀd͡ʑ
ˀdʒ	ˀd͡ʒ
ˀf	ˀf
ˀh	ˀh
ˀj	ˀj
ˀk	ˀk
ˀkp	ˀk͡p
ˀkx	ˀk͡x
ˀl	ˀl
ˀl̪	ˀl̪
ˀm	ˀm
ˀn	ˀn
ˀn̪	ˀn̪
ˀp	ˀp
ˀpf	ˀp͡f
ˀpt	ˀp͡t
ˀpɸ	ˀp͡ɸ
ˀq	ˀq
ˀqχ	ˀq͡χ
ˀr	ˀr
ˀr̪	ˀr̪
ˀs	ˀs
ˀs̪	ˀs̪
ˀt	ˀt
ˀt̪	ˀt̪
ˀts̪	ˀt̪͡s̪
ˀtɬ̪	ˀt̪͡ɬ̪
ˀtθ	ˀt̪͡θ
ˀts	ˀt͡s
ˀtɕ	ˀt͡ɕ
ˀtɬ	ˀt͡ɬ
ˀtʃ	ˀt͡ʃ
ˀv	ˀv
ˀw	ˀw
ˀx	ˀx
ˀz	ˀz
ˀz̪	ˀz̪
ˀç	ˀç
ˀð	ˀð
ˀħ	ˀħ
ˀŋ	ˀŋ
ˀǀ	ˀǀ
ˀǁ	ˀǁ
ˀǂ	ˀǂ
ˀǃ	ˀǃ
ˀɓ	ˀɓ
ˀɕ	ˀɕ
ˀɖ	ˀɖ
ˀɖʐ	ˀɖ͡ʐ
ˀɗ	ˀɗ
ˀɟ	ˀɟ
ˀɟʝ	ˀɟ͡ʝ
ˀɠ	ˀɠ
ˀg	ˀɡ
ˀgb	ˀɡ͡b
ˀgɣ	ˀɡ͡ɣ
ˀɢ	ˀɢ
ˀɢʁ	ˀɢ͡ʁ
ˀɣ	ˀɣ
ˀɥ	ˀɥ
ˀɦ	ˀɦ
ˀɧ	ˀɧ
ˀlˠ	ˀɫ
ˀɬ	ˀɬ
ˀɬ̪	ˀɬ̪
ˀɭ	ˀɭ
ˀɮ	ˀɮ
ˀɰ	ˀɰ
ˀɱ	ˀɱ
ˀɲ	ˀɲ
ˀɳ	ˀɳ
ˀɴ	ˀɴ
ˀɸ	ˀɸ
ˀɹ	ˀɹ
ˀɺ	ˀɺ
ˀɻ	ˀɻ
ˀɽ	ˀɽ
ˀɾ	ˀɾ
ˀʀ	ˀʀ
ˀʁ	ˀʁ
ˀʂ	ˀʂ
ˀʃ	ˀʃ
ˀʄ	ˀʄ
ˀʈ	ˀʈ
ˀʈʂ	ˀʈ͡ʂ
ˀʋ	ˀʋ
ˀʍ	ˀʍ
ˀʎ	ˀʎ
ˀʐ	ˀʐ
ˀʑ	ˀʑ
ˀʒ	ˀʒ
ˀʔ	ˀʔ
ˀʕ	ˀʕ
ˀʘ	ˀʘ
ˀʙ	ˀʙ
ˀʛ	ˀʛ
ˀʝ	ˀʝ
ˀʟ	ˀʟ
ˀβ	ˀβ
ˀθ	ˀθ
ˀχ	ˀχ
β	β
βʲ	βʲ
βʲʷ	βʲʷ
βʲː	βːʲ
βʷ	βʷ
βʷˀ	βʷˀ
βʷː	βːʷ
βʷˠ	βʷˠ
βʷˤ	βʷˤ
βˀ	βˀ
βː	βː
βˠː	βːˠ
βˤː	βˤː
βˠ	βˠ
βˤ	βˤ
β̃	β̃
β̃ː	β̃ː
β̃ˤ	β̃ˤ
β̝	β̝
β̞	β̞
β̟	β̟
β̠	β̠
βʱ	β̤
βʲʱ	β̤ʲ
βʷʱ	β̤ʷ
βʱː	β̤ː
βˠʱ	β̤ˠ
βˤʱ	β̤ˤ
β̩	β̩
β̰	β̰
β̰ʲ	β̰ʲ
β̰ʷ	β̰ʷ
β̰ː	β̰ː
β̰ˠ	β̰ˠ
β̰ˤ	β̰ˤ
β̰̃	β̰̃
θ	θ
θʰ	θʰ
θʲʰ	θʲʰ
θʷʰ	θʷʰ
θʰː	θʰː
θˠʰ	θʰˠ
θˤʰ	θˤʰ
θᶣʰ	θʰᶣ
θʲ	θʲ
θʲʷ	θʲʷ
θʲʷʰ	θʲʷʰ
θʼʲ	θʼʲ
θʲː	θːʲ
θʷ	θʷ
θʷʰː	θʷʰː
θʼʷ	θʼʷ
θʷˀ	θʷˀ
θʷː	θːʷ
θʷˠ	θʷˠ
θʷˠʰ	θʷˠʰ
θʷˤ	θʷˤ
θʷˤʰ	θʷˤʰ
θʼʷˤ	θʷˤʼ
θʼ	θʼ
θʼː	θʼː
θˀ	θˀ
θː	θː
θˠː	θːˠ
θˤː	θˤː
θˠ	θˠ
θˤ	θˤ
θʼˤ	θˤʼ
θ̝	θ̝
θ̞	θ̞
θ̟	θ̟
θ̠	θ̠
θ̩	θ̩
θ̺	θ̺
θ̻	θ̻
θᶣ	θᶣ
χ	χ
χʰ	χʰ
χʲʰ	χʲʰ
χʷʰ	χʷʰ
χʰː	χʰː
χˠʰ	χʰˠ
χˤʰ	χˤʰ
χᶣʰ	χʰᶣ
χʲ	χʲ
χʲʷ	χʲʷ
χʲʷʰ	χʲʷʰ
χʼʲ	χʼʲ
χʲː	χːʲ
χʷ	χʷ
χʷʰː	χʷʰː
χʼʷ	χʼʷ
χʷˀ	χʷˀ
χʷː	χːʷ
χʷˠ	χʷˠ
χʷˠʰ	χʷˠʰ
χʷˤ	χʷˤ
χʷˤʰ	χʷˤʰ
χʼʷˤ	χʷˤʼ
χʼ	χʼ
χʼː	χʼː
χˀ	χˀ
χː	χː
χˠː	χːˠ
χˤː	χˤː
χˠ	χˠ
χˤ	χˤ
χʼˤ	χˤʼ
χ̝	χ̝
χ̞	χ̞
χ̟	χ̟
χ̠	χ̠
χ̩	χ̩
χᶣ	χᶣ
ḁ	ḁ
ḁː	ḁː
ḁˠ	ḁˠ
ḁˤ	ḁˤ
ḛ	ḛ
ḛː	ḛː
ḛˠ	ḛˠ
ḛˤ	ḛˤ
ḛ̃	ḛ̃
ḭ	ḭ
ḭː	ḭː
ḭˠ	ḭˠ
ḭˤ	ḭˤ
ḭ̃	ḭ̃
ṳ	ṳ
ṳː	ṳː
ṳˤ	ṳˤ
u̥̤	ṳ̥
ṵ	ṵ
ṵː	ṵː
ṵˤ	ṵˤ
ṵ̃	ṵ̃
ṽ	ṽ
ṽː	ṽː
ṽˤ	ṽˤ
ṽ̰	ṽ̰
ẽ	ẽ
ẽː	ẽː
ẽˤ	ẽˤ
ỹ	ỹ
ỹː	ỹː
ỹˤ	ỹˤ
ỹ̰	ỹ̰
